信用交易日期,融资余额,融资买入额,融券余量,融券余量金额,融券卖出量,融资融券余额
20240112,823748027298,21746731504,6770998598,43981742694,793319581,867729769992
20240111,826638502547,24883034044,6772029359,44165915016,868170996,870804417563
20240110,825873985989,21436155506,6799798454,43836603508,852812795,869710589497
20240109,826897619326,22313020121,6768605717,44175523085,969865539,871073142411
20240108,828972334142,23302087686,6662116273,43706321644,885529774,872678655786
20240105,828709528427,25073487249,6596241529,44597581484,823692191,873307109911
20240104,832128138742,23266378224,6512928280,45059080779,781898133,877187219521
20240103,830994385460,25897354208,6462211120,45247507550,738140821,876241893010
20240102,831142083711,29195568421,6433706020,45410602806,750255986,876552686517
20231229,828481994098,28232657031,6536204679,46422445265,727695390,874904439363
20231228,832611883792,36621383591,6691976655,46741755671,942008014,879353639463
20231227,830639021091,22503311293,6679123258,46014742026,743731215,876653763117
20231226,830156676857,21230746202,6760876567,45719062783,706717229,875875739640
20231225,831537266706,20549828148,6700390714,45877114191,546761128,877414380897
20231222,831897728706,27869079433,6778478693,45963532338,784362212,877861261044
20231221,834932767439,27656443949,6790648178,46307444297,831406802,881240211736
20231220,834594703843,23313653463,6776168571,46080161668,787462551,880674865511
20231219,836972616963,24266150549,6757122251,46322684348,827745496,883295301311
20231218,836399914567,24246262686,6815286211,46851424356,764686554,883251338923
20231215,837463560463,27353561599,6847838055,47865813927,864957567,885329374390
20231214,837215537839,26518112052,6841065631,48636851306,774208650,885852389145
20231213,837709803552,28989397051,6896794131,48906147272,722237731,886615950824
20231212,836375013527,29131798775,6928950244,49433149957,759280756,885808163484
20231211,835600321392,34164787437,6922433973,49060818758,787004271,884661140150
20231208,834523805754,29866100296,7034435713,48635304818,722600730,883159110572
20231207,836082635421,27629671643,7034484282,48093447697,727193888,884176083118
20231206,834714468180,26561339651,7051604712,47895124348,696800656,882609592528
20231205,834215113904,28417475647,7154203297,48318510180,782555346,882533624084
20231204,834106455014,29573227789,7078061077,49543704470,661439112,883650159484
20231201,832924455327,28508786681,7078876734,50741128245,726287096,883665583572
20231130,832885252348,26216899060,7143611907,51375066115,820714933,884260318463
20231129,833655196071,28369174281,7020677342,50978629037,729389772,884633825108
20231128,833294508080,27508882284,7020418077,50912389246,664222044,884206897326
20231127,833404572997,30123304713,7028302432,51054322129,803006661,884458895126
20231124,832718672134,26389133440,6987094074,51039996603,844813331,883758668737
20231123,834956462548,29310386670,6826723296,51399752701,751553947,886356215249
20231122,834746932505,31034786402,6800715568,50635716749,701803147,885382649254
20231121,834331560086,36842645926,6811555719,51250543205,706650244,885582103291
20231120,835268167806,35675068879,6807208709,51537531307,733483623,886805699113
20231117,831975601530,30706446043,6755454590,51309672856,663821058,883285274386
20231116,832022057391,32344869758,6762178439,51583188706,708274093,883605246097
20231115,832357807380,41489944223,6750238597,51870286391,735193766,884228093771
20231114,830372804413,36829160734,6745516685,51276969641,746686219,881649774054
20231113,827991882641,32915456773,6727584337,50425505882,689623309,878417388523
20231110,825422662790,33882915945,6697656900,50702207206,783108381,876124869996
20231109,825047825135,37467347520,6669321257,50502775445,720348904,875550600580
20231108,824632593494,42089212839,6683928462,51699478096,723579358,876332071590
20231107,821526092866,40021854210,6668907721,51887739496,732267472,873413832362
20231106,819327277875,46913687849,6583149128,51607444241,752201988,870934722116
20231103,813165051421,29166742789,6582309527,50643380127,648598722,863808431548
20231102,815965385343,26714426048,6760168686,50496059895,658174086,866461445238
20231101,817813626569,31387603044,6791417840,51482447353,616424618,869296073922
20231031,815527162949,34298968475,6858045305,52362228119,599748869,867889391068
20231030,814889500260,40970282041,6928500667,52973852374,769395563,867863352634
20231027,810232952483,35137777511,6913055395,52171102204,885235712,862404054687
20231026,812505287117,29226926405,6848240198,51341454402,813233916,863846741519
20231025,812961564203,32556976870,6858887000,50997107570,794066469,863958671773
20231024,812882427571,29727480244,6815814422,51279651643,825373171,864162079214
20231023,812395870791,29433755708,6766191756,50459523408,793497220,862855394199
20231020,811513004395,27545803688,6763824897,51553777429,649035617,863066781824
20231019,811376046151,35291086782,6906995737,53008332396,684283695,864384378547
20231018,808695220942,29205025279,6909006000,53725264325,712156699,862420485267
20231017,808425392961,28112136967,6806979793,54697040599,666923556,863122433560
20231016,808650956659,30015373918,6761954222,54786990061,753050945,863437946720
20231013,806592107132,29329088805,6624999039,55268601453,522298111,861860708585
20231012,807184297945,30949713639,6729549837,55577268925,634947327,862761566870
20231011,805880232519,27426197596,6604904635,53688341916,541318738,859568574435
20231010,804714607611,28987732976,6527426661,52654038692,570177585,857368646303
20231009,801690693064,31026807036,6406245441,52167693557,638175528,853858386621
20230928,795595784222,25070351348,6064997165,51567951384,222699275,847163735606
20230927,803746732205,28066670412,6608977158,53691091197,429570391,857437823402
20230926,802938147537,25141302430,6971845444,54825088132,485045777,857763235669
20230925,802975697974,27936536825,7133084506,55776964564,528474182,858752662538
20230922,801602446146,30926857859,7214266710,56778317878,735951864,858380764024
20230921,802121565764,21463901693,7218682429,55808293282,628790638,857929859046
20230920,801652657829,21214744065,7274828434,56434452946,639706111,858087110775
20230919,801588926746,23726909214,7354549532,57419729950,756797457,859008656696
20230918,801762703001,27778181647,7404445539,57888188698,727715296,859650891699
20230915,799408861556,30769751911,7494750107,58145446321,718572540,857554307877
20230914,798244489927,25936130265,7574484558,58255454054,774244053,856499943981
20230913,797851219031,29096993798,7530491193,58601174318,789161189,856452393349
20230912,794765813108,29658910266,7481885863,59182552820,610633275,853948365928
20230911,790974243568,42768600735,7549806859,60017785665,887410346,850992029233
20230908,779001626762,22652805578,7431661129,59271606656,741661606,838273233418
20230907,780891295406,26026072315,7492672762,59158092130,812189783,840049387536
20230906,781718041569,27574201748,7516853427,60796219422,817678502,842514260991
20230905,780337204683,28888542387,7487161470,60353395951,802980767,840690600634
20230904,779105502412,32557057183,7458473482,60606130806,811260904,839711633218
20230901,776763712757,26020640275,7392453177,60094445978,726404520,836858158735
20230831,779233172137,28356604185,7346314773,59736019304,712465336,838969191441
20230830,780209182682,34761629931,7439031893,59770424147,829591121,839979606829
20230829,779967475132,37895869684,7398373331,58961217192,851648742,838928692324
20230828,777230010240,46377734261,7459922641,57140508458,951613191,834370518698
20230825,774247931274,22471393772,7334807275,55596569025,727187824,829844500299
20230824,778732166498,26009671985,7298350867,55988228117,819172062,834720394615
20230823,779374566390,22505466510,7165104341,55164783758,661290741,834539350148
20230822,780859067794,27867998132,7212255862,56590958454,826637201,837450026248
20230821,780702810581,23882923493,7082422894,55797012206,675183820,836499822787
20230818,779488941864,25801202257,7099946772,56621151764,664566443,836110093628
20230817,781341249849,26636484545,7098494381,57493285938,715603038,838834535787
20230816,780683965240,25095703173,7071981412,56699127170,721166341,837383092410
20230815,781100855178,23697522419,6991364386,56831724960,716741066,837932580138
20230814,781410434854,25662204082,6951828692,57172079393,633476916,838582514247
20230811,781024673066,28238197927,7034659080,58433107190,679246736,839457780256
20230810,783945120737,26094597384,7024408387,59768273625,578240029,843713394362
20230809,783843970802,25263051483,7117034835,60097815139,580085124,843941785941
20230808,784534538648,30828951387,7217658677,61372279546,657405465,845906818194
20230807,783981992071,34366525704,7247442363,61794678772,604651884,845776670843
20230804,781347963660,47526074267,7405135640,62977782149,811411080,844325745809
20230803,780671615824,34379293146,7398242835,62330402651,814939394,843002018475
20230802,779271737175,33915538813,7247923890,61246905070,718422071,840518642245
20230801,777008041989,35832435929,7325966779,61491153861,860567569,838499195850
20230731,776335930356,45069008200,7196003369,60840249445,787970676,837176179801
20230728,771738791954,36894571498,7086527432,60195147126,818521998,831933939080
20230727,772815264336,25967721907,6997680271,58697129495,700983884,831512393831
20230726,773033707971,25681636877,6945425837,58865277626,696066918,831898985597
20230725,773496328990,32276344452,6835043873,58601983217,761737005,832098312207
20230724,774175758666,18550144734,6661748047,56921495191,521735132,831097253857
20230721,775360683356,20106894775,6661480499,57195874443,584435949,832556557799
20230720,777341748149,23042192695,6685774085,57795486621,580270781,835137234770
20230719,779459367022,21878511579,6680897557,58794293689,578551497,838253660711
20230718,778981466192,23390547536,6696393995,59143200072,565022353,838124666264
20230717,779020474911,25678526228,6721647890,59703433738,553361549,838723908649
20230714,778136066520,28721906589,6751422032,60909876712,543301666,839045943232
20230713,779455604465,28537501080,6815261944,61102102664,665165547,840557707129
20230712,781051055987,28379473517,6827038558,60874165157,667959045,841925221144
20230711,782571583256,24097731300,6751370882,61672441528,608074478,844244024784
20230710,783201237762,23627925678,6822868946,61358467624,544609088,844559705386
20230707,782502584946,23780680733,6841675472,61689934823,595189578,844192519769
20230706,784261635891,25489623661,6866410932,62096603149,552004774,846358239040
20230705,784278132120,27901681283,6886346892,61995322065,645276124,846273454185
20230704,783971478800,31065237733,6751215484,61733754443,654432666,845705233243
20230703,783998849919,33142995173,6719510382,60694315544,645274147,844693165463
20230630,783226088823,27309997850,6713214002,60532458737,610419746,843758547560
20230629,786410667420,26514129575,6710839263,59665190822,640860826,846075858242
20230628,786231800629,27264386632,6639392901,59223754768,645328552,845455555397
20230627,787120957421,25712321340,6634316390,59255026913,638480207,846375984334
20230626,787712188223,30325997922,6598785642,58550600026,709987220,846262788249
20230621,787037186941,30950449122,6566863145,60099376043,728145047,847136562984
20230620,791093597800,37134539992,6526189753,62318950358,616416340,853412548158
20230619,789971120399,38313085520,6590359420,62313380941,597538838,852284501340
20230616,788591168297,35841902523,6703101055,62436774101,675672112,851027942398
20230615,790327545076,36104897686,6718067687,61008608635,654285824,851336153711
20230614,790676904593,32449376010,6755156616,60369429201,674289023,851046333794
20230613,790865774379,29236899642,6743033321,59773830620,659897308,850639604999
20230612,791473411003,30227755249,6790344251,59169026164,624105592,850642437167
20230609,789638708164,27747941908,6798375497,59662343427,718946579,849301051591
20230608,791651918244,26119135041,6812621658,58699994282,734547797,850351912526
20230607,792864051105,24692557493,6766991827,59107795660,637279393,851971846765
20230606,793531616301,29246709768,6781770763,59520867169,698591593,853052483470
20230605,794800775064,27997486124,6722682386,61480105606,567402067,856280880670
20230602,793763018085,29398140318,6745813522,61496845684,670445631,855259863769
20230601,796618537929,32505924160,6728329099,61712279227,696119679,858330817156
20230531,796016352690,28420628810,6705768233,61709130779,694906444,857725483469
20230530,796022808390,30329812566,6698911465,61457780501,693295501,857480588891
20230529,796322875039,29383052812,6649903361,60648589648,655800096,856971464687
20230526,796563903105,28292151877,6592914720,60443283278,719580929,857007186383
20230525,798781795051,28264242706,6575370800,59557453096,673615885,858339248147
20230524,798521240902,28861751329,6653561331,59816960224,648214269,858338201126
20230523,797617811068,25759027666,6672654451,60161537878,601601928,857779348946
20230522,797939206150,27045233953,6720725557,61745906391,657810482,859685112541
20230519,798990859126,30208952640,6672384075,62054337253,618034297,861045196379
20230518,800333234607,31303458484,6781272394,62162336558,655316528,862495571165
20230517,799104757554,27656510917,6709915512,61965826648,578935447,861070584202
20230516,798441709558,29918961732,6811596862,62462633003,631599355,860904342561
20230515,799775256756,35632057054,6770114736,62185354765,649560080,861960611521
20230512,798267472951,29534685922,6777541652,61282813098,615977834,859550286049
20230511,801209857357,32184905589,6796949139,61877251778,593832834,863087109135
20230510,801598265500,40209797332,6823253684,61915233321,692326610,863513498821
20230509,800169991423,55860294017,6851113100,61964448683,772312655,862134440106
20230508,798372769570,48370404576,6727009409,61872780224,750396191,860245549794
20230505,793879016645,40232453981,6576217765,60387059542,595780484,854266076187
20230504,795839338310,45694907696,6594431587,60838163313,631752554,856677501623
20230428,791218147988,40755540950,6443717077,60737828997,637608900,851955976985
20230427,796676029935,37212492014,6466951539,60041536638,625056460,856717566573
20230426,798837650589,38340974485,6462714487,59326186421,653063191,858163837010
20230425,801483664728,38934629730,6451599086,59699301593,660357332,861182966321
20230424,805078300023,37498242845,6559367383,61044949011,593894642,866123249034
20230421,804442630750,45923860618,6604522077,62362398763,658973627,866805029513
20230420,807839232663,46624192858,6618087392,64777027195,617181291,872616259858
20230419,805311386298,44363451113,6653688732,63492538974,639965435,868803925272
20230418,804908546312,42381170767,6619408306,62847354366,673123706,867755900678
20230417,804682524065,46609728811,6523128219,62688374810,685972707,867370898875
20230414,802768804602,43041935099,6404991109,61974404427,597005094,864743209029
20230413,803802923593,42232410183,6424120762,60479722651,623867131,864282646244
20230412,804889674276,46060362771,6405359025,60951032566,631620656,865840706842
20230411,801692525018,39861394451,6311194939,60045128240,636039742,861737653258
20230410,801981114346,48299240663,6388492565,60038159884,597722416,862019274230
20230407,802280042944,42883030721,6372231997,60811666711,525022348,863091709655
20230406,803674047378,51649107415,6441987277,60117233471,560812904,863791280849
20230404,798904170550,51543030759,6376485599,59246036017,631367040,858150206567
20230403,798616296684,49362946517,6320393519,59167685939,587049485,857783982623
20230331,795034645806,34106238293,6306690389,57857790616,532623743,852892436422
20230330,797243830185,37602878950,6375504922,58173621523,553843872,855417451708
20230329,796888526748,36917444239,6492010880,59231954420,575699974,856120481168
20230328,797252237740,35127786654,6539413217,58777799031,588539553,856030036771
20230327,796768269592,43139342595,6526652915,58966395162,618706964,855734664754
20230324,792841223125,40411479676,6512687872,58733357057,556275072,851574580182
20230323,791799900643,40663545338,6631184198,59259651500,645260577,851059552143
20230322,789655461766,33975138391,6578226708,57770405696,566705818,847425867462
20230321,788520782368,32669309838,6551344201,57318367220,537181647,845839149588
20230320,787692438328,41814575636,6614620910,57188845639,572666105,844881283967
20230317,786383574652,39068034165,6652153657,57345804327,576102845,843729378979
20230316,787162950283,34281085965,6701653873,56568983753,560917271,843731934036
20230315,786734165922,33710304348,6686525580,57374956856,522934621,844109122778
20230314,786046973151,37826288637,6655015938,57277312922,540912991,843324286073
20230313,783799930630,31700153724,6705327275,57611243790,561642955,841411174420
20230310,783197568414,28706138749,6637325012,57253867475,530153517,840451435889
20230309,785759082363,28751641632,6765492286,58568937176,560661303,844328019539
20230308,784081753629,27177785002,6716643544,58141530889,458706880,842223284518
20230307,782936967560,37584155624,6823715107,58485896449,561062984,841422864009
20230306,783317669963,38130658311,6824305235,59434100431,544520836,842751770394
20230303,780729766109,35621014751,6791993108,58906191476,575898753,839635957585
20230302,781178829117,33989864554,6730586569,58425274731,449943327,839604103848
20230301,781822473154,35308992850,6734831452,58689745794,567416295,840512218948
20230228,780900136995,27200620472,6659381693,57781281778,463086630,838681418773
20230227,780503115387,26558966376,6721526358,58164049606,520045516,838667164993
20230224,780666428046,26922542436,6701327844,58969017855,447133832,839635445901
20230223,781042560533,29265249647,6787882686,59941122756,497576934,840983683289
20230222,780900121090,28726816154,6736958279,60054621098,455720903,840954742188
20230221,778991977830,35195700903,6708063823,60297565226,566903318,839289543056
20230220,777618595903,35628718244,6626532533,60505211610,650051079,838123807513
20230217,775379729131,28747268997,6501904077,59149363469,468847437,834529092600
20230216,777614732387,42753088780,6608957137,60074297316,598874330,837689029703
20230215,778814595507,32199142338,6549197613,60659772698,462720365,839474368205
20230214,776791296318,30447188784,6508139361,60271399307,429781586,837062695625
20230213,775115514066,34203591703,6521528525,60336878016,493899094,835452392082
20230210,772176553297,28454742865,6529405240,60233235214,481021931,832409788511
20230209,773789184027,30714147343,6522908581,60666614866,479672832,834455798893
20230208,773692157939,25263749848,6509557099,58987511030,424020754,832679668969
20230207,773091617246,28077917457,6458353608,59135979568,511921669,832227596814
20230206,771265612492,30871164379,6356188861,58450949920,499283483,829716562412
20230203,768724731038,33723508407,6363340352,58636081553,464177639,827360812591
20230202,767838008722,38482533499,6383665829,58661906036,472231031,826499914758
20230201,765593071927,38596177407,6346691008,57879344454,478144906,823472416381
20230131,761554614916,32944039881,6253829172,56868675926,403995014,818423290842
20230130,758324039887,44182544303,6291917882,57662644387,478613981,815986684274
20230120,747919975441,28442552716,6125230222,58426085977,255265772,806346061418
20230119,755726974240,25505153144,6356226331,59208561771,353007803,814935536011
20230118,756622347867,21287640240,6502505019,58901754251,294571182,815524102118
20230117,758825329203,23874455214,6636924408,59669539891,400544568,818494869094
20230116,760316664530,35534790586,6684054778,59928133409,456113165,820244797939
20230113,759845686031,23173898664,6832619186,59479935478,402986733,819325621509
20230112,762379933298,21703105873,6836208610,58599665132,378111605,820979598430
20230111,763770671980,24005209350,6859696916,58337995594,390331349,822108667574
20230110,764994925871,25231350747,6880562487,58717235669,378409698,823712161540
20230109,764824244326,28651317201,6886158803,58693893160,450907620,823518137486
20230106,763344296620,26190740179,6827350153,58366274215,417364751,821710570835
20230105,764779384596,26348490112,6917985699,58350501542,452755366,823129886138
20230104,764418863386,23466972941,6927554764,57419073503,530551124,821837936889
20230103,764350187189,26269848785,6862759148,57213980296,445888539,821564167485
20221230,762514201807,16023998297,7057585015,57481916398,499473735,819996118205
20221229,766760403679,18918496091,7040645548,57934262914,521047974,824694666593
20221228,766472799612,18237066622,6934872196,57798601098,401425334,824271400710
20221227,768300105500,21088507725,6916107608,57820141009,458934286,826120246509
20221226,769283179666,19941179477,6848777529,57204574946,367496800,826487754612
20221223,767808102655,17297446476,6860257165,56044709502,463497372,823852812157
20221222,770308253069,20572824853,6887320638,56658280171,438827097,826966533240
20221221,772131190941,16297029837,6881438251,57013919879,404833420,829145110820
20221220,773741005498,20367794636,6900584458,57279770334,484635519,831020775832
20221219,773295688119,25693480619,6914424322,57931388701,485538339,831227076820
20221216,774732973259,22599879266,6978801390,59364086665,449600870,834097059924
20221215,777754941694,24966536463,6953131685,59690169852,465319236,837445111546
20221214,777087007843,28121653373,7000325556,59844226632,457945932,836931234475
20221213,778706150308,23842285880,7023878684,59880719357,320918527,838586869665
20221212,779477957495,33348971402,7073753236,60419639246,432499389,839897596741
20221209,776138478545,33791776732,7203726270,60948571736,476407422,837087050281
20221208,777198575304,29953697411,7278045929,60936788485,428136294,838135363789
20221207,777182938303,34852447964,7246603286,60809679806,509991630,837992618109
20221206,776103539100,36375765216,7243747526,60983181033,450641379,837086720133
20221205,776039754984,42871935274,7299457815,61216860136,590576934,837256615120
20221202,772184356386,29155770062,7188623061,60759429440,445661375,832943785826
20221201,773006882074,38793135489,7353539317,62302017268,455233907,835308899342
20221130,771424149549,30399589348,7457688672,62484447264,524244050,833908596813
20221129,773818172180,38087593766,7472116345,63248254585,628018116,837066426765
20221128,772868801219,26858193078,7402017115,62464324929,461545564,835333126148
20221125,772544316046,23969432803,7490419318,63653489773,517895242,836197805819
20221124,776161135356,24182818630,7475602830,64252687919,492463165,840413823275
20221123,777002601688,29313190599,7430593107,63708252821,533701525,840710854509
20221122,776834636854,30864366469,7428142622,64067523773,567541921,840902160627
20221121,777077218098,28293261410,7368084011,64943264614,472814923,842020482712
20221118,774607255920,31935381317,7417572694,65638328535,446997380,840245584455
20221117,777288642064,32481113899,7604932457,67960162820,468478702,845248804884
20221116,775839406247,32292268511,7701842799,67645128058,440110154,843484534305
20221115,775706762626,39324289597,7721323206,68504011545,550064841,844210774171
20221114,773920229118,35957773092,7727232277,66743896074,506223716,840664125192
20221111,773552787965,42433322610,7715467968,67274401724,514797310,840827189689
20221110,777550981686,26487720456,7852046992,67264167767,490485573,844815149453
20221109,777824824498,25183520037,7827237928,67446351571,344075536,845271176069
20221108,777224082043,27431361085,7868119836,68109226287,408835598,845333308330
20221107,775900520228,36692366299,7902441104,68554557244,494577130,844455077472
20221104,772462692744,39413824543,7944796342,69624982497,555394573,842087675241
20221103,772623348328,29779927512,8069899356,69051958105,406979053,841675306433
20221102,770284229577,36947176392,8154936579,69157555118,483701840,839441784695
20221101,769667966856,33053275067,8197543085,68592932538,547412241,838260899394
20221031,768736970587,28965833092,8161947094,66991486894,485347010,835728457481
20221028,768599549673,26785595840,8159625569,66464225035,489692213,835063774708
20221027,774796204610,29277661794,8182116678,68318608870,492279833,843114813480
20221026,775833466675,30907985414,8152533788,68412991694,497646331,844246458369
20221025,773969828275,24854361339,8314082319,67547329350,500771313,841517157625
20221024,774821459548,32790490624,8313594807,67595042357,558011235,842416501905
20221021,773692767359,23127096298,8255373809,68291178351,472408157,841983945710
20221020,776269929247,26883206762,8248303204,68130975055,653835823,844400904302
20221019,775306396795,24274840803,8000837867,66868108922,383143030,842174505717
20221018,773992838909,25724901685,7995417220,67445030416,479571845,841437869325
20221017,773363951153,27676632060,7864495824,66354123433,414621510,839718074586
20221014,772023311463,29856859671,7882573380,65651636507,477227508,837674947970
20221013,772376809092,23535235092,7910990923,63634478610,471532790,836011287702
20221012,771370482389,23835677500,7851311771,63259946092,555564374,834630428481
20221011,770735102720,16395842232,7750938758,60942006203,431844219,831677108923
20221010,771203514053,20021628982,7769766475,60460888802,426957702,831664402855
20220930,770623751931,13867959000,7747368483,61980206085,353753815,832603958016
20220929,778830915826,18390339803,7884254334,63789998932,373087685,842620914758
20220928,781113221616,17589202162,8059695502,64718874306,434609094,845832095922
20220927,785240104940,19878687696,8065160723,66091755915,418747499,851331860855
20220926,785774425677,20067682944,8173447663,65068764666,416576533,850843190343
20220923,787247836470,19496402651,8282498987,66418539201,433244770,853666375671
20220922,791371965565,19798752526,8290020067,67420878401,381731244,858792843966
20220921,792373742514,19510872336,8328622696,67466886141,451876089,859840628655
20220920,792317272001,19654660682,8293175265,67723390752,427448889,860040662753
20220919,791758426442,18923812969,8223044097,66723565869,465711231,858481992311
20220916,793641670445,24450668225,8155522310,66812393359,453752132,860454063804
20220915,796544742207,28557210441,8158071040,68322179307,535590337,864866921514
20220914,799281463122,23265486232,8044937931,69444444184,382151574,868725907306
20220913,799641281579,26155022955,8058462163,69852396881,386597799,869493678460
20220909,797665884010,23834570929,8009367516,69348638154,419210034,867014522164
20220908,802936935915,23961974540,8068443516,69498455458,372832193,872435391373
20220907,804203104743,27853115750,8040312203,69805592535,384565762,874008697278
20220906,803513344268,27800142775,8024105463,69481020611,431669320,872994364879
20220905,804717543345,24010007024,7995303768,68217966804,522735556,872935510149
20220902,804547309813,21929299716,9617322440,67846342686,382832601,872393652499
20220901,805956223789,22785085346,9674226619,67626600084,420425339,873582823873
20220831,807729362103,29590569191,9685817846,67641547722,657524169,875370909825
20220830,812992456940,25489676641,9549272306,68519738825,451687153,881512195765
20220829,814151763169,26099736281,9565632119,68928377843,489002506,883080141012
20220826,813729709479,27455992496,9330815773,69313799949,483549747,883043509428
20220825,816965812332,32208838770,9199075065,68921511628,520935438,885887323960
20220824,818520354358,35823734058,9118815508,68587982412,598446613,887108336770
20220823,821273324019,34333619919,8963926435,70332089957,678213318,891605413976
20220822,819764989605,33511752383,8698741605,69738009821,522687266,889502999426
20220819,818796898343,36597143211,8582375879,68973265062,445368439,887770163405
20220818,821505494211,34424608214,8568077665,70060666031,475285798,891566160242
20220817,820026080300,35056653572,8530232389,69335777525,490555737,889361857825
20220816,819254198291,33860919426,8478784107,68789483520,463062809,888043681811
20220815,817951632910,32660333036,8426693989,68246585573,376459692,886198218483
20220812,815776022678,32741042484,8549074354,68627101865,454255752,884403124543
20220811,818175734041,37674496174,8504352629,68929652326,468928007,887105386367
20220810,818375102481,32201768047,8467456202,67670779003,369203520,886045881484
20220809,816962196621,31711301756,8474192955,67835090165,403661541,884797286786
20220808,814640869080,31536561905,8426558141,67325512668,444880412,881966381748
20220805,813049843823,34390585662,8324883207,66718746809,629819525,879768590632
20220804,813705139650,28416543518,8145387298,64511564452,675106377,878216704102
20220803,812291833769,35871316460,7905362691,63546053793,633056485,875837887562
20220802,813462510618,35377146872,7732617092,63261255414,533775056,876723766032
20220801,818992456447,31178592295,7683419170,64215210576,410368695,883207667023
20220729,818061069544,31822181298,7675955930,63864994896,458048151,881926064440
20220728,820081385003,32908914029,7687158148,64570753061,464982506,884652138064
20220727,819846008863,27682660786,7653129218,64161423121,365661409,884007431984
20220726,818271843241,26296720021,7702906332,63735038595,410147830,882006881836
20220725,818877487640,26605640093,7733793268,63315557034,510277286,882193044674
20220722,819125924113,31598198519,7627876510,63428133072,487471265,882554057185
20220721,820120344143,36486633015,7586361524,62845739998,419220221,882966084141
20220720,819291476832,32845807949,7653354534,63207502714,404783807,882498979546
20220719,818368021163,32107635239,7620539324,62682997977,463112844,881051019140
20220718,816693870032,33996089175,7542419418,62363955895,412043919,879057825927
20220715,814971261389,37629148735,7577495924,61484021300,477429422,876455282689
20220714,816457913392,36646453803,7556219418,61663350657,475522882,878121264049
20220713,814864156128,31953471126,7540048417,61059706506,451432077,875923862634
20220712,814427103321,33023882202,7558058678,60590080802,487248995,875017184123
20220711,815819236317,35840995623,7505888510,61525665140,470542673,877344901457
20220708,815301810057,36901495340,7496149470,62516717201,471137309,877818527258
20220707,816739788005,38432399454,7514044921,62799030682,511952501,879538818687
20220706,815649145513,43176377194,7417321964,61882153159,442466243,877531298672
20220705,813443887342,46991426779,7511448730,62508003069,579793979,875951890411
20220704,811494011440,44184226573,7380297182,61911620491,470668061,873405631931
20220701,807893323016,41649257686,7409562756,60713899537,489681818,868607222553
20220630,810173314834,48938425785,7374838978,60817834131,509409100,870991148965
20220629,807930379714,50628051048,7282918953,59077158831,497907556,867007538545
20220628,808027652202,50553431904,7267810692,59815485114,421878756,867843137316
20220627,804152526967,51884714653,7395969503,59791030542,499412140,863943557509
20220624,799101774063,46175566005,7331298421,59505969329,486506974,858607743392
20220623,799470136679,43485869406,7303722166,58406024132,593666045,857876160811
20220622,799032181409,39381731122,7202903031,56795824636,533081862,855828006045
20220621,796791144096,40973948034,7081932430,56654901493,546112960,853446045589
20220620,798401593884,47621368258,6947200236,55919104321,436995541,854320698205
20220617,793940350029,42842107943,6912217032,55290070732,488522030,849230420761
20220616,795756728177,46332368237,6829715717,54303015634,513905855,850059743811
20220615,793609922510,60233212499,6806672978,53630674633,536441330,847240597143
20220614,790607292252,46309952318,6746225243,53645550512,516131314,844252842764
20220613,788358540702,46456817098,6719466010,52968807177,358946148,841327347879
20220610,782256232225,40644204686,6804798344,53407136031,433434045,835663368256
20220609,783308464450,40170903056,6799639919,52404335067,418839625,835712799517
20220608,782800121321,42456429312,6780858854,52993770720,417879945,835793892041
20220607,782087338586,40369581839,6717922195,52066610135,424711562,834153948721
20220606,779744766199,45572370540,6696024920,51968916749,411713519,831713682948
20220602,774052689799,33212400666,6732059063,51135633893,357872320,825188323692
20220601,775888801375,31727310989,6879480606,51585163239,381178041,827473964614
20220531,775391474256,33689864145,7035432100,53057211038,404044523,828448685294
20220530,775287251445,28828692641,7068071328,52697294429,375800935,827984545874
20220527,773904370625,27821963225,7077719965,52583662540,425545860,826488033165
20220526,776861193425,29832186051,7058633343,52820379548,457431838,829681572973
20220525,776948782318,25937119939,7022615469,52204915179,413871505,829153697497
20220524,776297399896,33478029692,7015920291,51651620693,448286431,827949020589
20220523,778251389141,32521595141,7001179308,53221305635,353296401,831472694776
20220520,775382706063,33767095002,7046384161,53183938436,425875818,828566644499
20220519,777272455643,28549629945,7080802348,52727098167,351373585,829999553810
20220518,776847783482,27500489730,7371621666,53532469913,444023474,830380253395
20220517,775207185635,27111927442,7363773513,53650496250,363882188,828857681885
20220516,775727439591,26612709458,7445671805,53763561213,441486773,829491000804
20220513,774154774214,26167766245,7372917513,53675475425,372338060,827830249639
20220512,775606280676,26914556259,7361088230,52909367615,388976604,828515648291
20220511,775240016082,38403416303,7382840412,53013939363,481245077,828253955445
20220510,773026055278,27256529038,7339307209,52106753550,467727752,825132808828
20220509,772594360832,22707793277,7331423743,50879248692,385204432,823473609524
20220506,770636270872,27637288223,7258886874,50419805818,408668586,821056076690
20220505,770358757845,31316444374,7190436721,50751399941,369868407,821110157786
20220429,768384978166,31722518791,7115552175,49902445908,377087902,818287424074
20220428,774383614466,26564141949,7308715551,49704535022,440752116,824088149488
20220427,779434455889,28641152694,7271719006,50065757672,481213490,829500213561
20220426,785342465926,24934800980,7262577906,48569515995,476240509,833911981921
20220425,798777756593,29535916782,7252342872,49807748287,483164799,848585504880
20220422,808088418338,21241215896,7290233865,53784978649,409538574,861873396987
20220421,814245491550,26506452438,7264944537,54094996612,450616388,868340488162
20220420,818724649829,28011197875,7225566963,55236348804,398817322,873960998633
20220419,818341922489,26410715343,7201021558,56474168583,367875691,874816091072
20220418,818459315143,29298053925,7221477672,56954126509,360024869,875413441652
20220415,818388672866,32955053953,7278302397,57487330858,384627074,875876003724
20220414,822208340708,32967755189,7208223356,57457842581,355662630,879666183289
20220413,823145306933,30299298345,7210724031,56661701951,382598666,879807008884
20220412,824919866194,32701576186,7162984018,57140452706,392855065,882060318900
20220411,825857374580,32982315894,7224048505,56498439856,394644957,882355814436
20220408,828836634090,31799704613,7215779952,58449918563,413905163,887286552653
20220407,831706002323,30739230689,7159158507,57955025668,412167449,889661027991
20220406,833503942754,36268817131,7126677334,58758356633,411844709,892262299387
20220401,829794726178,31269605890,7053935692,58502398831,317169696,888297125009
20220331,834878658068,33323175632,7161858051,59404387646,296303659,894283045714
20220330,837963805834,34874518471,7176129112,60121859805,351834380,898085665639
20220329,835896947038,27762065487,7288455284,59141234094,310913876,895038181132
20220328,836838011083,28226118070,7301136869,59865591804,361945653,896703602887
20220325,837409442628,31060061466,7317497964,60059605268,355363240,897469047896
20220324,839618088604,31089984629,7286730681,61105079215,330461726,900723167819
20220323,840333260621,33113235366,7301365539,61526204201,342394536,901859464822
20220322,840092127566,31948615138,7274332627,60932585977,383722812,901024713543
20220321,840383540777,35280451221,7232160304,61042001258,443213211,901425542035
20220318,837539032759,32741222765,7129956740,60233391954,429085693,897772424713
20220317,843697373088,42852969549,7095088508,59780632258,480466387,903478005346
20220316,846194275056,41493302322,6993193567,58683148896,467580646,904877423952
20220315,848623434249,39248985306,7107629537,57513628861,475542741,906137063110
20220314,854517735470,34156710585,7020451524,59635613557,342123126,914153349027
20220311,853309031318,36722130553,7007195509,61395468139,398066943,914704499457
20220310,855756680056,35721876611,7020475191,60899288776,460874164,916655968832
20220309,856888363483,40331946755,6923094499,59701475361,494022153,916589838844
20220308,859765307764,40621032091,6837642138,59544810258,411571424,919310118022
20220307,859249648231,38002845554,6763967865,60540929964,331772912,919790578195
20220304,856218564496,33748990174,6744721747,61847334343,289918372,918065898839
20220303,858343094456,36976863382,6833314785,62867627397,302981712,921210721853
20220302,859052842301,31820705317,6822172437,62964589847,331524263,922017432148
20220301,858304931586,34534560384,6758944437,63055096244,354385418,921360027830
20220228,858010482942,32685307599,6647605888,62044753873,303879192,920055236815
20220225,857890092841,36054568394,6694818276,61561853385,319754816,919451946226
20220224,859170791373,48897327108,6736030040,61590156396,387100408,920760947769
20220223,859158753274,36391242811,6761764661,62758341598,322733315,921917094872
20220222,856149573287,33426558686,6755461901,61458973035,309415297,917608546322
20220221,854404344357,30163407887,6743228054,62246614874,250001572,916650959231
20220218,851255690984,25778155366,6770550852,62368337142,245162157,913624028126
20220217,853470424387,28464686653,6817210351,62545298411,301424906,916015722798
20220216,853461937896,24734170700,6764039244,62289200189,266509212,915751138085
20220215,853614767892,25909466346,6725968120,61947518943,262927556,915562286835
20220214,852506500811,28602302085,6724149913,60968329760,214567154,913474830571
20220211,849788559074,30934333775,6780239975,61938605900,243821637,911727164974
20220210,853570690387,29621852856,6798387705,62421930804,284336216,915992621191
20220209,854850368933,30336916681,6838008023,62437858058,267397642,917288226991
20220208,854484927188,29090527058,6839315202,61059264042,351533250,915544191230
20220207,855901800819,27310266202,6791621128,60215503155,305413640,916117303974
20220128,854740314467,23132952667,6688387295,59174427770,233346885,913914742237
20220127,868250393955,24620243523,6785459506,60473114561,241068704,928723508516
20220126,872693075234,23898167033,6885648236,63184486286,320615634,935877561520
20220125,875761757447,30148004614,6883328915,62815257517,238690735,938577014964
20220124,879433636370,26403922588,6967230248,65372745895,205496472,944806382265
20220121,881353735363,31160145530,7113806329,66795846737,229791508,948149582100
20220120,886686826861,35407631063,7150618551,67834549214,297200548,954521376075
20220119,892008945432,31365456127,7137349632,68403399190,225656834,960412344622
20220118,895190092705,37925439622,7204032282,69781414468,280363582,964971507173
20220117,896735334253,35910564085,7181925055,69711053098,218382833,966446387351
20220114,895539506386,37429274986,7213149205,69193804514,198865887,964733310900
20220113,897215444391,35756831126,7307329256,69762671602,208731780,966978115993
20220112,898405575020,34954508284,7379376625,70938053988,256655035,969343629008
20220111,896737126432,34470087686,7381310239,70433794659,238267567,967170921091
20220110,896873723408,33991345816,7351682503,71151294063,236847633,968025017471
20220107,895813442330,37040847589,7347023572,71268730282,197057658,967082172612
20220106,904082746979,35147602767,7398899422,72154331847,247773025,976237078826
20220105,904167215798,41441867406,7374898946,72172661033,239561597,976339876831
20220104,906057651977,43225523638,7425000720,73986984743,212529992,980044636720
20211231,903074844982,35086122406,7856597209,77526443094,324024197,980601288076
20211230,908562701859,34730627768,7777311639,76855862617,415320812,985418564476
20211229,908622510506,32634308832,7616064858,74743594125,328403102,983366104631
20211228,909665874508,33059173489,7557685688,75093237297,257517318,984759111805
20211227,907936630520,34462816755,7639180627,74946640037,246929691,982883270557
20211224,905742911873,40269156117,7670593709,75488891458,265029679,981231803331
20211223,910955003301,37489306028,7613599765,75917503766,283256915,986872507067
20211222,910705749396,34969631563,7518737988,74995953775,250088416,985701703171
20211221,910211617764,34206403936,7499951051,74784920407,288124157,984996538171
20211220,911283958963,36475815857,7485124045,74383433532,237192776,985667392495
20211217,912380095462,40249533352,7516205481,75503822107,257418358,987883917569
20211216,916542583380,39615692249,7498260351,76418145995,272698227,992960729375
20211215,917286307636,41489543228,7480900638,76384758167,278816931,993671065803
20211214,915338431382,41167413592,7482782843,77021710188,218304535,992360141570
20211213,913950078858,48895575668,7499629807,77804138164,212546575,991754217022
20211210,910033221248,43886035015,7500910611,77680483273,186412928,987713704521
20211209,908880092802,49857018620,7567207405,78400671615,229122615,987280764417
20211208,907881320453,42276318790,7568010727,78143700115,248789101,986025020568
20211207,906117771051,43135827601,7531357204,77132981263,249054975,983250752314
20211206,907463353414,45490504601,7541633270,77826059128,274109768,985289412542
20211203,907443980718,41216130997,7483428616,78650822945,313523901,986094803663
20211202,908489878210,38409376235,7424060581,78118238432,222146964,986608116642
20211201,910308466514,38128286098,7604603826,81073668514,215337014,991382135028
20211130,908483085484,40994523589,7670747313,82042756602,216958336,990525842086
20211129,906873810702,41921659792,7716317763,82853907417,219058017,989727718119
20211126,904436858616,37193288982,7755927342,82756122106,176626664,987192980722
20211125,905679295346,39546784309,7789060637,83150510946,184601581,988829806292
20211124,904574071421,42353285513,7787465420,83526135212,252782557,988100206633
20211123,904116936824,45229945425,7786592760,84311209210,259601860,988428146034
20211122,902371955149,46186133754,7772729201,84978454593,245997975,987350409742
20211119,896957362621,37705003805,7832746754,85085143521,236196959,982042506142
20211118,897810789912,36889117611,7839348849,84617589176,234463923,982428379088
20211117,896710208816,33042433944,7855128385,85331457592,174135656,982041666408
20211116,895203793301,35725653903,7946830244,85833109101,231808384,981036902402
20211115,897001566079,38014892449,7913583404,86771474996,194971076,983773041075
20211112,896986190333,37409750345,7958398713,88357465487,183178633,985343655820
20211111,899651946243,40845453722,8001363295,88945920482,231769188,988597866725
20211110,899331842771,38213740740,7976232002,88283798030,254662884,987615640801
20211109,898707817919,36197603337,7984987066,88399996368,236304227,987107814287
20211108,896875925401,34657377284,8021072954,88505142150,188996318,985381067551
20211105,895795759951,39102989555,8182178329,89713336499,194202979,985509096450
20211104,902439884671,40931845606,8291073849,91306599468,196519508,993746484139
20211103,900087292307,34982691989,8393896623,91816672291,200769071,991903964598
20211102,902216238930,48420329736,8472205265,92685102054,267184479,994901340984
20211101,904908107430,46606105277,8496606040,93989314278,200522082,998897421708
20211029,903863548830,43520693551,8522639342,94180423183,205134822,998043972013
20211028,906812813649,41100174730,8660369379,95344964238,203595181,1002157777887
20211027,910663397709,42423046786,8873074524,99452559483,207620657,1010115957192
20211026,908601388757,41992255878,8903806080,101528305116,249715837,1010129693873
20211025,905911108778,39970769027,8888564422,102003833773,223734747,1007914942551
20211022,903152283548,37616194601,8874439563,101302784274,193849281,1004455067822
20211021,906155333844,40350578074,8896570924,101855206036,210896836,1008010539880
20211020,905782630328,41278425865,8899072679,102318301335,202952676,1008100931663
20211019,902716530777,38149744526,8865935647,101979877014,233048482,1004696407791
20211018,901100271885,41038828992,8815899764,101018597121,193940880,1002118869006
20211015,895814114221,33925573306,8774160431,101117724592,203783469,996931838813
20211014,898738267985,33001218091,8731566637,100024800121,211470420,998763068106
20211013,898870170634,34878678284,8660660856,99443662266,213077783,998313832900
20211012,900741231360,37906014955,8620578439,98092384334,305462215,998833615694
20211011,902622940053,39312230297,8510107992,99137683894,235607206,1001760623947
20211008,901386226189,43814526350,8450600284,98809444804,192141641,1000195670993
20210930,896254829811,34050236728,8383890718,97797889923,140868063,994052719734
20210929,906996167002,41078137304,8522245819,98621341782,227865806,1005617508784
20210928,912997702505,40684816167,8623096503,101217004259,253054200,1014214706764
20210927,914364873491,55209063606,8594295559,100943333095,282728397,1015308206586
20210924,921279018246,52299976833,8577353424,102690600224,274008897,1023969618470
20210923,926721903101,60521358820,8553340629,103357515443,304160389,1030079418544
20210922,922535888976,55066782639,8460713582,102145956992,232047759,1024681845968
20210917,918229550357,56799118824,8434497906,101569628292,308884909,1019799178649
20210916,928450655117,62812468076,8519943804,103023440954,259896297,1031474096071
20210915,933956191047,59579067963,8524306698,105045833373,191118285,1039002024420
20210914,931887499426,64458724366,8610372674,106757605514,251012665,1038645104940
20210913,930764129760,74688081068,8630741888,108239179285,298055524,1039003309045
20210910,923583113669,80842562738,8573759510,108416022741,308362893,1031999136410
20210909,922785428017,71655913658,8573933777,107211525130,297802445,1029996953147
20210908,916346887959,71760709336,8520802344,107164175566,274574331,1023511063525
20210907,910090394094,70057212943,8540317146,108236745391,348717096,1018327139485
20210906,906099410796,66674031592,8481850742,106286080856,319750891,1012385491652
20210903,900676269106,75719281139,8430280122,104758890713,296836888,1005435159819
20210902,902656833418,70371946215,8429825646,104774234814,313886617,1007431068232
20210901,901344977545,86597069009,8387209427,103663834893,297521935,1005008812438
20210831,899385982475,69614291662,8423755945,103419407592,333742485,1002805390067
20210830,899089666980,71793951316,8360167492,102812042868,245771889,1001901709848
20210827,894912847257,57941035122,8369892377,103216094853,271881085,998128942110
20210826,898406898219,64515650603,8406372915,102531436626,304988634,1000938334845
20210825,895334183375,59483131832,8367973218,104461948415,297335095,999796131790
20210824,893429651301,64950589822,8308655028,103911933129,305646808,997341584430
20210823,890417780550,59821872994,8342383142,102556909435,371511949,992974689985
20210820,882309838568,49629607117,8211197721,100256058076,244483963,982565896644
20210819,884683739098,51429984562,8250185771,101508510619,332956016,986192249717
20210818,887500266893,53111294208,8172352671,101079206938,324023464,988579473831
20210817,885923828822,53096929565,8135895799,98996714339,267796168,984920543161
20210816,890815556382,51451588746,8180481491,101704194792,239666561,992519751174
20210813,891183785513,53515465795,8194218038,101897097267,215300631,993080882780
20210812,893309284237,55756608511,8190920190,102560567635,248548010,995869851872
20210811,889399169595,53852472884,8184424887,101808014682,357816435,991207184277
20210810,887179157175,52545175434,8026491785,101170598664,255515009,988349755839
20210809,887076996399,54715347711,8010161696,100382674700,290011638,987459671099
20210806,884172429529,53337436391,8003081634,100149418320,225081253,984321847849
20210805,882804292001,54638374264,8006536154,100122802739,319642645,982927094740
20210804,881972881172,56117682644,7907422697,99568232422,294717070,981541113594
20210803,879217994964,57995438660,7813160708,97463262183,339154043,976681257147
20210802,880443503451,68516927730,7859272769,98413628446,397380210,978857131897
20210730,875692505732,54021721651,7702378905,96449617205,244606875,972142122937
20210729,877935876728,54235311628,7698184456,96359375974,293419711,974295252702
20210728,875017626385,48356000041,7631125526,93589940718,233371172,968607567103
20210727,881974200598,71454914962,7630322539,94275342063,213227696,976249542661
20210726,884072314143,66240315749,7681352956,95893696994,196868693,979966011137
20210723,881396553942,64333614411,7712000053,97519995976,233540705,978916549918
20210722,881145142633,60847410671,7667577789,98110496208,213883534,979255638841
20210721,876263677708,56322486216,7612193302,96723158455,195989058,972986836163
20210720,872574217435,39771819830,7578597733,95771947704,154650329,968346165139
20210719,872204634809,47652085060,7614943150,95819794833,186814534,968024429642
20210716,871247201089,54210169393,7637373133,96779729001,205342646,968026930090
20210715,872344914304,49569635475,7623805567,97754617076,249340621,970099531380
20210714,872899264566,49127695555,7602801357,96898381507,188136996,969797646073
20210713,874128252202,52999475374,7632443941,98793660256,160922169,972921912458
20210712,872053294616,60029647754,7684911308,99093982686,225759468,971147277302
20210709,866811908074,48759691637,7642230810,97782026131,187480769,964593934205
20210708,866722341986,55077237551,7667678475,97837012758,196001166,964559354744
20210707,863753184065,48316967173,7663595177,97738107781,237484271,961491291846
20210706,859643243967,47946515849,7613582528,96185914625,225599228,955829158592
20210705,859728229295,43066238704,7557190745,96693294825,161344662,956421524120
20210702,856383116685,42976990424,7554806567,95923383838,147389749,952306500523
20210701,857176520953,45824988192,7682469190,98377654813,251418825,955554175766
20210630,862822810436,44505649291,7574604746,97989516575,208509898,960812327011
20210629,860723220494,42600865590,7575268718,97250925168,198127638,957974145662
20210628,858117612067,47922630182,7599120335,98416288080,208414321,956533900147
20210625,852621255199,47328461295,7614671070,98433820758,259011599,951055075957
20210624,852782054553,42346827777,7584685519,96686312451,327595571,949468367004
20210623,851813694053,47863196438,7497384756,97013206319,317732336,948826900372
20210622,851273356925,42217943380,7454536907,95872308809,409310836,947145665734
20210621,848131601893,41856642056,7275259267,94074701537,227193127,942206303430
20210618,845059995477,45162874854,7261768204,94182040713,293043821,939242036190
20210617,842780416135,38138621260,7243839839,94043330416,260296267,936823746551
20210616,839898644373,35873363148,7208670717,92196146572,233355996,932094790945
20210615,841056218056,41401213886,7267949455,93632221967,142746885,934688440023
20210611,837408440042,46654028231,7337267756,95141038807,145957576,932549478849
20210610,840153205978,43091332729,7397986868,96388010833,183098741,936541216811
20210609,838589270926,37514123480,7386547128,95181846107,172439205,933771117033
20210608,838114869374,42617807399,7430227561,95352511203,177292511,933467380577
20210607,837659288066,43242508531,7533716307,96224840497,247077433,933884128563
20210604,833301157301,41762305697,7522505681,95827290882,207494702,929128448183
20210603,834774042167,43633522404,7629065437,95791782639,265582318,930565824806
20210602,833882640084,44860057103,7593901758,96564019908,246432551,930446659992
20210601,832469753416,48419949351,7659340565,98541793291,259064080,931011546707
20210531,827953586295,48051805038,7591873010,97530642986,170500778,925484229281
20210528,821972013714,46937250469,7612680532,96720679933,284333949,918692693647
20210527,820729295439,43663317475,7493772587,96271117458,161339499,917000412897
20210526,816490842964,47285027257,7539786184,95582848083,197355526,912073691047
20210525,814261003267,47786319801,7535457991,95616627044,237353754,909877630311
20210524,813674545450,35978153268,7567755725,93387489939,169827163,907062035389
20210521,810670237086,33088299956,7583192534,93520442395,154286777,904190679481
20210520,811462296683,38063059561,7613394978,94363899469,166174901,905826196152
20210519,810481964331,37542704957,7634436517,94558242212,164487412,905040206543
20210518,808587241994,35682191958,7681525209,95448344728,163407543,904035586722
20210517,807065819160,42543040132,7697814427,95485002123,178717801,902550821283
20210514,804800999074,42976802579,7732531587,94271785076,220891175,899072784150
20210513,805229017067,34527892725,7725117727,92218075762,155937025,897447092829
20210512,804277321885,33079658103,7770063018,93106397068,167178486,897383718953
20210511,802469810548,38332066610,7833575501,92247555457,174521350,894717366005
20210510,801540647009,39763830509,7833859145,91450051268,185761984,892990698277
20210507,797991832859,40747653569,7797933316,91027465952,194558469,889019298811
20210506,797716392311,39783452654,7766528206,91434870430,135785794,889151262741
20210430,793351750738,36829069449,7783077468,91993888735,141528413,885345639473
20210429,799593299537,35635083363,7838256130,93515387693,213091517,893108687230
20210428,801048423429,33983698073,7775074172,92598728863,184649551,893647152292
20210427,799784841520,29825458175,7759775081,91962187850,188101387,891747029370
20210426,800606899865,38417202066,7754308517,92122345346,212163864,892729245211
20210423,798915127810,29826488858,7739507541,92409138544,159291639,891324266354
20210422,801362797628,29048400797,7756566493,92119814846,175409188,893482612474
20210421,800209654159,29268825126,7753815238,92131021033,156717163,892340675192
20210420,799379211818,33588880620,7746820182,91811860934,246825826,891191072752
20210419,798163983816,34976133831,7653729671,91633834128,187475531,889797817944
20210416,796060470679,25825496200,7636468277,89663300262,201254611,885723770941
20210415,796817584862,23704746678,7673238419,89002051878,195096232,885819636740
20210414,796769159448,24228232053,7671085355,89208925697,222807685,885978085145
20210413,796009150413,23061667437,7643778326,89179178184,201327453,885188328597
20210412,799161820983,28873800028,7633163131,89179217640,216936599,888341038623
20210409,799847556152,27075190407,7691643191,90402211447,200467970,890249767599
20210408,800340627444,31653267123,7701196243,90592526566,247634346,890933154010
20210407,799996518343,29228878414,7635652295,89809555464,235411090,889806073807
20210406,796954365915,28231697364,7580367217,89677613587,233615752,886631979502
20210402,794150731478,29811143961,7493974245,89630523651,227113143,883781255129
20210401,795949098021,27957193285,7476144710,88803355251,216616640,884752453272
20210331,797053733339,28198849972,7498164752,88007216933,292380473,885060950272
20210330,795773068523,29631171999,7425932537,88253543459,253282118,884026611982
20210329,795015266755,29267194510,7357259961,87581319556,281756828,882596586311
20210326,794126530855,27927807443,7294689788,86560938158,261221426,880687469013
20210325,794874768272,22927278853,7299151954,84966938499,162249974,879841706771
20210324,797166421861,30179125610,7401302027,85689029422,244792766,882855451283
20210323,797829780590,29564844757,7487422329,86981766854,237432487,884811547444
20210322,799080919527,30745425911,7512232112,87759194104,264363700,886840113631
20210319,797113296291,30074027009,7480780962,85648282903,273012692,882761579194
20210318,797938882384,29354524810,7507061922,87290875350,282695094,885229757734
20210317,799559077424,29039426432,7445795673,86458609364,222388427,886017686788
20210316,798752178835,30250377088,7441348577,86530061500,197217784,885282240335
20210315,800532718804,36875911204,7484507948,86432898617,225238543,886965617421
20210312,798267706264,35109661371,7498087535,87829914459,294149748,886097620723
20210311,800321367759,35137589573,7393089908,86576219122,245527204,886897586881
20210310,799146556678,28777814657,7328338157,83156918867,205701918,882303475545
20210309,802276032864,39315458528,7348865006,82881970525,227694716,885158003389
20210308,806617415006,43602898883,7483357336,85305228863,229051556,891922643869
20210305,806221304478,38603742759,7453762584,87709922023,203625497,893931226501
20210304,809064212364,44587579185,7526193504,88211554720,188622992,897275767084
20210303,812100512664,39984005981,7580150558,90678716817,250876757,902779229481
20210302,811873629757,42318072306,7524101377,88272256394,232314104,900145886151
20210301,810117759809,39826789094,7457213895,88680489245,236994218,898798249054
20210226,806306694237,40358250701,7405796972,86823536945,243345852,893130231182
20210225,809129415626,45910107347,7418394956,89122765668,241251980,898252181294
20210224,809020164487,49327003200,7318389586,87837357217,232624017,896857521704
20210223,808409083165,48043375715,7321626453,89191681408,212526735,897600764573
20210222,810360452570,70756180553,7290337464,88421888961,266709721,898782341531
20210219,802437603320,54940481670,7207830734,89502507162,232925268,891940110482
20210218,798674299752,57592470219,7227617856,88984489407,203012743,887658789159
20210210,787516930548,39732264789,7154213412,87009856851,162455427,874526787399
20210209,796972031083,40412055719,7320527938,88627326311,187447390,885599357394
20210208,796355371775,33386752258,7346080807,87718590706,148374362,884073962481
20210205,798537947597,39256505179,7386121711,87230537840,169481352,885768485437
20210204,802902827539,41486860920,7395161264,87780973049,164920794,890683800588
20210203,807189978760,42621756166,7461530990,88548469683,251518719,895738448443
20210202,807418158794,37533872673,7386440829,88303226275,230032183,895721385069
20210201,807900109492,33787419612,7373859344,87699520622,149203855,895599630114
20210129,808530764245,40134151406,7418247336,87886463615,169207629,896417227860
20210128,814568038845,39663396119,7519107173,88928321949,190077276,903496360794
20210127,816237694539,40145362869,7590674819,90980664752,225718852,907218359291
20210126,816084569630,45345746275,7579969244,91134644981,226620712,907219214611
20210125,819391832231,60567215502,7539432027,92462918141,191550594,911854750372
20210122,815403994518,54522258866,7495142610,92052121202,171809713,907456115720
20210121,815992756519,53942981845,7546963003,92320595051,263176590,908313351570
20210120,811252474957,44656991305,7483348034,90865328670,233236788,902117803627
20210119,807854268016,51955888008,7497668717,90148843460,245938223,898003111476
20210118,805075741296,49647422370,7462895649,90706543444,248088203,895782284740
20210115,801616826104,51163771731,7433722056,89976786638,241058265,891593612742
20210114,802748756831,57155041776,7481775857,90132664618,193248585,892881421449
20210113,802444845154,64017454573,7568477066,91225089301,265844397,893669934455
20210112,799390393893,57361406150,7530545403,91746211267,325524873,891136605160
20210111,793378564093,56336207102,7520064144,89464441339,255624629,882843005432
20210108,792770084113,52918009775,7474415641,89862795925,228993758,882632880038
20210107,792507228848,59965393124,7551589895,89277970861,262208935,881785199709
20210106,789702817707,55516064817,7474335440,87154562339,238041357,876857380046
20210105,786485232814,64068720689,7400044350,85919034933,274234682,872404267747
20210104,780490219310,59792059099,7333166907,85594916893,297843212,866085136203
20201231,768366961044,47044329212,7242552164,85655479796,404717525,854022440840
20201230,768713795726,38017076240,7056124500,83064123526,275215318,851777919252
20201229,766565014922,36771234951,6977669280,80638951944,256400655,847203966866
20201228,769227904714,40242435610,6960948136,80589379015,293876336,849817283729
20201225,767303833177,39514925337,6840426533,80241447592,212627478,847545280769
20201224,765792112747,37664871207,6858885402,79216193814,281000483,845008306561
20201223,766290955690,42346213495,6747858480,78453775600,213183482,844744731290
20201222,764320464544,45629345481,6766001197,77708549565,308249025,842029014109
20201221,763664230810,41766344322,6646202307,78456815787,207242475,842121046597
20201218,759171142789,35499760915,6640411495,77774434895,270689757,836945577684
20201217,758568721435,36511166237,6539696530,77518310538,237251560,836087031973
20201216,757250182818,28745028616,6496016293,75701406763,169900786,832951589581
20201215,756368148234,28577175125,6498944926,75117651670,252521935,831485799904
20201214,755709036504,29444773356,6430324025,74178418405,195393978,829887454909
20201211,753613864795,33665033981,6402915619,73211845296,197261938,826825710091
20201210,755649047599,31291093912,6437504460,73912195189,187002425,829561242788
20201209,754519180325,32383741100,6381108117,73200119119,250337826,827719299444
20201208,757976387724,31182662211,6285979488,73727696066,206352926,831704083790
20201207,756851607868,34715895237,6326277875,73997349125,197128489,830848956993
20201204,754258913777,34598642790,6387275794,74667979451,250712141,828926893228
20201203,753985375607,37374017034,6366140449,74758649924,287462885,828744025531
20201202,752828422299,40768179703,6399714984,75450814751,302559213,828279237050
20201201,749657391509,41657448357,6330311833,74688612595,233378474,824346004104
20201130,747061399190,48767051230,6397974301,73543488297,247004396,820604887487
20201127,743489604691,32734883184,6365784101,73557269829,189608178,817046874520
20201126,744973294987,31358289181,6345627322,72515479525,166886446,817488774512
20201125,746180978294,40713255244,6391009272,72425427362,177190530,818606405656
20201124,745084788566,38523407714,6371381905,73675678147,171889064,818760466713
20201123,742675022714,48655916053,6407149099,73972476201,258469533,816647498915
20201120,737865462670,31183957732,6347463941,72722586462,181484434,810588049132
20201119,737923991149,30378829634,6356246119,72313114235,160182965,810237105384
20201118,738724749306,35748609611,6403230391,72556533453,238117944,811281282759
20201117,738190820752,35020934966,6406686878,72072766835,243085720,810263587587
20201116,738105266238,32904358627,6323453584,71541892509,214655414,809647158747
20201113,735796686341,29673116233,6242880951,70299741541,190274965,806096427882
20201112,735155468482,27595611938,6234857479,70750032916,171501155,805905501398
20201111,735194222361,35054286792,6188943578,70388625153,167585715,805582847514
20201110,736348759208,39198734903,6175513417,70922451222,274565723,807271210430
20201109,736547030957,48348514805,6039713902,70222461104,225017082,806769492061
20201106,730307648470,32974594647,6041097107,68466997485,160492040,798774645955
20201105,731306759721,33074080085,6034379500,68472573064,184635128,799779332785
20201104,729638305309,26653953913,6030629218,67469313599,199967943,797107618908
20201103,728262128568,29691652653,5967673756,66580696143,183110099,794842824711
20201102,726761818581,29579707654,5932690294,65117582278,154716405,791879400859
20201030,726579583483,30622827539,5911183017,64665330733,210974656,791244914216
20201029,730205468600,27724508747,5839567052,64545398802,199401002,794750867402
20201028,729233081780,24666448336,5768902174,63104614686,179565537,792337696466
20201027,728401575575,19431592478,5739265071,62062133766,135122031,790463709341
20201026,728064512071,24138051819,5777589612,62038648862,170994230,790103160933
20201023,728885246959,24772322668,5780770666,62074847684,159273021,790960094643
20201022,733209692892,23277229042,5810868587,63333461385,159131283,796543154277
20201021,732558183793,24190070047,5865226373,64349459310,229270670,796907643103
20201020,732194798565,22064697825,5743619627,63102699867,198792980,795297498432
20201019,731751610228,29754413853,5693447096,62233207156,234477597,793984817384
20201016,730157187663,24408716429,5596004600,61570839515,194965095,791728027178
20201015,731454593803,26432417334,5581038003,60972229982,207847977,792426823785
20201014,731954188699,28756960217,5587155934,60819379583,249273686,792773568282
20201013,729474250695,32646696187,5499055837,60173891097,318845668,789648141792
20201012,726418414800,38579671714,5336988893,59129953563,262749295,785548368363
20201009,722623954673,26951364149,5202217824,55633049538,145122064,778257004211
20200930,718773947637,16674985182,5141204785,53929546016,196923906,772703493653
20200929,726928420180,19341548887,5197381561,54931049944,159305930,781859470124
20200928,728325003590,17978559789,5306110930,55233077687,197549089,783558081277
20200925,730801783480,20449470754,5252695746,55177763739,216085248,785979547219
20200924,732858922643,24134224677,5261496389,55421493595,292556844,788280416238
20200923,732305245167,23823816726,5196001642,56265953207,227958336,788571198374
20200922,731247489707,27538630180,5126546536,54686844272,288105153,785934333979
20200921,730726552552,28407598569,5005189658,53933475742,225379158,784660028294
20200918,731266023818,34946555390,4933315701,53388869210,275383881,784654893028
20200917,730029382106,28381120882,4843073540,50969951084,187199030,780999333190
20200916,728439717981,22563293997,4868840826,50209857556,224530329,778649575537
20200915,729117519444,24342779376,4782943355,49556138759,243391427,778673658203
20200914,729061180106,22654661047,4684777238,48242131887,232461282,777303311993
20200911,728111760910,22963813892,4580381929,46911770982,221302978,775023531892
20200910,729123226445,26991223005,4581892736,46304102934,218901734,775427329379
20200909,733691061340,32530259321,4533904621,46125019964,214270502,779816081304
20200908,736096993567,31575477663,4534400012,47056940490,207007555,783153934057
20200907,737269953161,34785048598,4529672343,46381511691,209769832,783651464852
20200904,738886120757,29264357402,4477523680,46914534374,156265206,785800655131
20200903,740658070283,34227945887,4515155795,46865880564,213602091,787523950847
20200902,741383469957,37055853302,4458269605,45765230020,274007225,787148699977
20200901,738562557286,33426894682,4306130454,44685422170,156328586,783247979456
20200831,737496841386,48048396588,4300591221,44296887927,236852095,781793729313
20200828,732783678329,40444382927,4250834482,43797383484,197958538,776581061813
20200827,731588258795,31931260230,4283837339,42494022394,178602321,774082281189
20200826,731526000698,37360373004,4291181688,41553249805,200605548,773079250503
20200825,734610783208,34878351569,4273675693,41751009607,204319692,776361792815
20200824,736231596569,34133645247,4247176940,41586346616,238851959,777817943185
20200821,735221001471,35992406507,4196516379,41355164574,196118235,776576166045
20200820,736808467432,37637844019,4215268611,41088228825,203660295,777896696257
20200819,738102277544,54701448400,4271604287,41327647233,302792889,779429924777
20200818,737139287741,55881433850,4159733077,41334347970,236068903,778473635711
20200817,732081513102,65322276877,4155128026,41418544936,311910304,773500058038
20200814,723080350545,37650488956,4056482332,39646308936,191773421,762726659481
20200813,726545298137,39514011152,4141355835,39748687723,260684847,766293985860
20200812,726584281714,48451850896,4064823698,38853247680,288869294,765437529394
20200811,729671717222,56655911478,4061661240,38831696496,295878548,768503413718
20200810,732624432487,63179003993,4034724855,39485819080,316805941,772110251567
20200807,729497666990,62547591107,3928422375,37939285889,296214374,767436952879
20200806,734608599055,68894152082,3878355461,37773301613,344923057,772381900668
20200805,732690221755,63615720413,3736982532,36604455998,297156705,769294677753
20200804,725683475209,70004717047,3666750500,35317571125,309137465,761001046334
20200803,725137948042,70046682051,3563045769,34424485120,316679138,759562433162
20200731,715121775818,56445034914,3480507044,32837176033,272717385,747958951851
20200730,712590778640,54741149053,3495351043,32332813204,259054463,744923591844
20200729,709581445856,53062685862,3402750725,31690902150,241098134,741272348006
20200728,703851065382,41294371024,3440113732,30282021131,301593210,734133086513
20200727,703259741449,43207902291,3318883565,29478693733,298401126,732738435182
20200724,700715314451,60354064866,3252209184,29163570123,322993668,729878884574
20200723,708063785728,63461931223,3213785309,30602804283,312236166,738666590011
20200722,704025960797,60654693446,3147297924,30584549816,333713454,734610510613
20200721,701417603825,53598876864,3090810575,29649465360,290091255,731067069185
20200720,701056904736,60722523027,3016715457,29142336350,374734434,730199241086
20200717,696844708851,47549848559,2848098766,27039379780,264640177,723884088631
20200716,701564857416,72455893119,2892204370,27127683849,313713784,728692541265
20200715,703088755528,79253823624,2942837071,28396318145,307538473,731485073673
20200714,700304768072,87080935672,2907350265,28799866749,305787290,729104634821
20200713,693969954893,95775836288,2999854003,29193995414,346574249,723163950307
20200710,678735135575,91251348273,2939391237,28018816781,258183788,706753952356
20200709,669814955947,101080373908,2985237576,28783810047,292979495,698598765994
20200708,657755813850,93339326675,2972596371,28108136154,330721452,685863950004
20200707,640490679043,100048804583,2906050374,26708307238,269008163,667198986281
20200706,627556881275,94920843388,3022533689,26892935690,298919742,654449816965
20200703,606187612076,65531619065,3053992521,25291043834,248589004,631478655910
20200702,599389899784,55991742719,3028360649,24857923277,222335011,624247823061
20200701,593499380417,45796675255,3081730913,24288816962,285129448,617788197379
20200630,588541166170,37148889306,2934997254,23225333319,185711804,611766499489
20200629,583149719849,30378396073,2913521799,22596962927,152798833,605746682776
20200624,578986495858,29214194352,2890345192,22721280148,145468956,601707776006
20200623,582362137952,32250630317,2913100707,22842179983,200122253,605204317935
20200622,579997002944,38542084417,2873748861,22440958515,160481169,602437961459
20200619,574584041996,32350124280,2875398255,21883528063,138359842,596467570059
20200618,574702654882,30004790919,3006520158,22076853179,164461112,596779508061
20200617,572629011059,26967131825,2993084453,21737615310,166614433,594366626369
20200616,571708480538,27293210690,2951765795,21198109730,172115498,592906590268
20200615,569218261248,28010468536,2939099272,20658576583,165910546,589876837831
20200612,567784675205,25245172617,2887442138,20444785037,153551087,588229460242
20200611,567697168308,27707978727,2900235189,20639926290,150273641,588337094598
20200610,566139309135,22426053065,2864767563,20411854037,146116033,586551163172
20200609,565324951356,23252995272,2824688131,20309613666,145300195,585634565022
20200608,564623246283,26725075721,2803788393,20041409794,163764696,584664656077
20200605,562693813584,24381448548,2751046118,19816808151,143771110,582510621735
20200604,562154767159,24375601180,2744718466,19865720591,139017894,582020487750
20200603,560353938047,28347745184,2694539366,19691409939,116230832,580045347986
20200602,560049208115,27655143944,2717711645,19766677439,150550196,579815885554
20200601,559577690993,31631706362,2676981427,19599773364,123586027,579177464357
20200529,555018097562,19238870510,2722088930,19040519488,139699902,574058617050
20200528,556679561665,20995560490,2689167514,18816728323,148722169,575496289988
20200527,557552127210,20015094791,2644806991,18486941223,187917546,576039068433
20200526,557499732122,18243331094,2571740036,18226328693,180625950,575726060815
20200525,556476814207,17463239847,2532465031,17654210985,131964596,574131025192
20200522,556339825469,22627019165,2498802660,17692725636,137287701,574032551105
20200521,557611667024,23010495437,2524710129,18222270406,134036774,575833937430
20200520,558071029282,25707860106,2508782159,18353112907,145517489,576424142189
20200519,558516802310,26625304248,2477246097,18292774157,152950926,576809576467
20200518,556568601275,28257957499,2460073719,17901672127,175441999,574470273402
20200515,555066959688,23634951499,2373921204,17405073381,105358929,572472033069
20200514,555669875057,22639567863,2487338135,17676989860,127985541,573346864917
20200513,554829513206,20992712377,2473026500,17561035424,162317600,572390548630
20200512,554421178255,22869141226,2411432632,17150465810,153247628,571571644065
20200511,553137209402,28261481153,2414690941,17038053566,186646482,570175262968
20200508,550055155563,29206285529,2335661760,16625161563,120763294,566680317126
20200507,548983059716,26876926878,2373983367,16343509394,182497813,565326569110
20200506,546427698550,31340468220,2282299095,15877403656,159606290,562305102206
20200430,540087048500,27301197826,2238389479,15146808419,113194596,555233856919
20200429,543684772162,20903912083,2345150166,15375592530,157497464,559060364692
20200428,546719357234,24084402812,2323607664,15393454190,197935682,562112811424
20200427,549190163750,19726959881,2316237097,15372801801,168252317,564562965551
20200424,550033499023,20653564238,2264563881,15154930270,113936501,565188429293
20200423,552995180646,23547042759,2340955792,15556897570,145016533,568552078216
20200422,552974194763,21815366141,2303866316,15503800347,159447749,568477995110
20200421,552024405126,23840199938,2270582434,15081371939,182849256,567105777065
20200420,552092865833,22155303147,2211138220,15046194193,175716752,567139060026
20200417,551148283066,27927304450,2151090517,14591362491,202428496,565739645557
20200416,552724896743,22311172284,2110017110,14274813311,171608829,566999710054
20200415,551400055359,22033432563,2119067323,14100736265,172298558,565500791624
20200414,551453038319,20580637053,2118843845,14242299495,195593647,565695337814
20200413,551402967203,17122642107,2111020249,13890502521,157212642,565293469724
20200410,552122826513,23901918992,2077428751,13878515875,196191369,566001342388
20200409,555131422688,24940682994,2040805216,14059883513,210901066,569191306201
20200408,555044653995,23631666517,1933276828,13362414398,179835698,568407068393
20200407,556005279122,29027163780,1901657369,13249670300,205019454,569254949422
20200403,554642771517,18410396097,1832289979,12564550797,162650722,567207322314
20200402,558526402294,21662678601,1811795579,12826845911,155578788,571353248205
20200401,559305882671,19697942546,1840792791,12595285666,189262236,571901168337
20200331,562713019950,20744436959,1795420131,12388253833,196854474,575101273783
20200330,564031495104,22576159335,1730500294,11993510332,164653551,576025005436
20200327,565477732570,24403231198,1750427521,12299462107,189313139,577777194677
20200326,567775129391,23466311560,1762193307,12316132506,229909484,580091261897
20200325,569239231247,29705703083,1671376427,12000239629,245364293,581239470876
20200324,568532351819,25675496483,1560513994,11320671610,169292223,579853023429
20200323,569697127931,24130274917,1600599374,11132685684,211409817,580829813615
20200320,573455088179,25780281341,1566882344,11346890936,200164163,584801979115
20200319,576795028671,33760354753,1559624298,11128823487,197084236,587923852158
20200318,575453741797,31406343302,1666270724,11420378410,333526732,586874120207
20200317,579300265730,31973698009,1485261271,10818556171,199130211,590118821901
20200316,578948250524,35878076855,1588578124,11168216763,268008438,590116467287
20200313,585866095442,40253720911,1503010536,11354864353,204700818,597220959795
20200312,589062499522,34930386707,1568344794,11611034849,209309116,600673534371
20200311,590756731201,42546395028,1560136974,11804392633,277240794,602561123834
20200310,591394308733,46881445479,1434003889,11428906521,186496966,602823215254
20200309,591181177560,47356173135,1554248499,11431440825,233183514,602612618385
20200306,590460217993,40921467877,1481925727,11697981525,121020326,602158199518
20200305,594628864283,59739363828,1541224525,12441415101,249898827,607070279384
20200304,589223256850,44052510624,1432677528,11715841728,188052945,600939098578
20200303,587708596032,54347170867,1411929761,11691238927,227521357,599399834959
20200302,584892862349,45691129457,1339469696,11088678301,212427693,595981540650
20200228,582209646574,42695281497,1317477434,10550966306,183296830,592760612880
20200227,589914863168,43639489627,1373727551,11370281903,145391292,601285145071
20200226,591118726025,59482019923,1396921409,11405888789,213870435,602524614814
20200225,590115848980,62412767506,1343936397,11318963864,173767566,601434812844
20200224,586415776616,56662525057,1351973514,11231601726,180154403,597647378342
20200221,579970674213,54790838593,1285189680,10921373087,120527624,590892047300
20200220,577770431812,50651791080,1301360101,10754071099,155046392,588524502911
20200219,574072376028,44611198356,1273518468,10416491507,132541902,584488867535
20200218,573602028083,44582485006,1219049007,10232506176,132178888,583834534259
20200217,568927550285,43034434520,1185340151,9982728806,133901551,578910279091
20200214,564842574521,35262531666,1153986079,9399512538,106083603,574242087059
20200213,565269286069,36519148029,1133619420,9092676707,106038388,574361962776
20200212,564705327037,33501425705,1121672459,8901457391,147358558,573606784428
20200211,562460299122,30460935925,1030091238,8019682181,123344161,570479981303
20200210,563895597858,36246045806,948104632,7327030143,89381236,571222628001
20200207,561920858486,37686809856,892168591,6781955757,12658396,568702814243
20200206,562022699504,38529608000,902348168,6767457936,21876515,568790157440
20200205,559232297605,34111829016,907084280,6720508658,20452355,565952806263
20200204,559952837462,35461810593,898811733,6523438866,8797144,566476276328
20200203,561975455459,24109695957,937514913,6552228192,30463860,568527683651
20200123,568373798279,34244816895,990888122,7983489656,60154447,576357287935
20200122,576330861708,31496052112,1088204785,8897364678,88170687,585228226386
20200121,576301105902,32678736729,1131694540,9324777990,78871039,585625883892
20200120,576303022728,31214023833,1199160052,9795394680,86523162,586098417408
20200117,575491812969,25894205952,1215946775,9769443013,102038655,585261255982
20200116,576558354303,25940815347,1221476856,9707122701,77798384,586265477004
20200115,575929132790,26948638728,1303001970,10022583450,104965738,585951716240
20200114,574945207770,31344441336,1373527039,10491659685,132289083,585436867455
20200113,573021434835,31004102581,1378978778,10507325406,151862524,583528760241
20200110,570739934602,26873586822,1351861829,10298596512,125463113,581038531114
20200109,571819012961,31039484561,1375596816,10520442935,146253476,582339455896
20200108,570740658657,35809712248,1394737021,10510224534,155611085,581250883191
20200107,568793261762,32940743825,1455991934,11143113227,144904491,579936374989
20200106,567760802437,39971310371,1474025681,11193485547,171138826,578954287984
20200103,562710881010,33474395954,1435983771,10918911096,109430958,573629792106
20200102,561396722311,39665569600,1490508270,11292893947,168868829,572689616258
20191231,559055426838,25568407895,1447051229,10892767928,129981453,569948194766
20191230,558917674707,33037624018,1444706324,10977853200,144365707,569895527907
20191227,555111529883,29198997533,1437175167,10728653748,141021546,565840183631
20191226,555995394376,23272150392,1415181275,10768745221,138329500,566764139597
20191225,555015167639,21470493409,1376783886,10617458513,121723569,565632626152
20191224,554400951209,18060475599,1351656004,10351193007,129289560,564752144216
20191223,556003821374,23047433720,1348942900,10274213691,120141931,566278035065
20191220,555035446253,23989420203,1370612694,10699260739,90852504,565734706992
20191219,556309366942,24116730229,1403640067,10986525236,102483602,567295892178
20191218,554466188124,29684776793,1413650473,11107457966,122335778,565573646090
20191217,551516610507,35126663542,1457433748,11152939293,152548014,562669549800
20191216,548288053609,27740021378,1453192249,10964588638,113223026,559252642247
20191213,544431163367,23244118842,1444631533,10983715047,125984881,555414878414
20191212,544762356034,15711214718,1449227888,10838303677,87173923,555600659711
20191211,544826951629,17600728458,1471918166,11075497150,126737025,555902448779
20191210,544324601840,16553966156,1447008017,10955300849,105260612,555279902689
20191209,543860276636,17900924528,1445576172,10790307026,100396834,554650583662
20191206,542900227729,14616539198,1444561455,10726461920,98802670,553626689649
20191205,542948225200,15459928808,1441954965,10685864537,107604853,553634089737
20191204,542474281717,13279715249,1470526895,10660723132,102076170,553135004849
20191203,541820549640,12801148711,1477914576,10647205327,107441067,552467754967
20191202,540793588479,12560008717,1470760045,10612426512,118497814,551406014991
20191129,540589918492,12991522208,1441946376,10569738432,90454610,551159656924
20191128,540557833985,10775496820,1524787250,10982996908,95713107,551540830893
20191127,541540132118,12741492721,1520163466,10974380903,94772628,552514513021
20191126,541048628299,11852995009,1514266671,10917987011,96442723,551966615310
20191125,542994841271,17083962116,1504943312,10841632264,137074241,553836473535
20191122,542558701610,17908370560,1453759192,10591990623,110304324,553150692233
20191121,544024320788,13785300418,1477321159,10841484084,117840892,554865804872
20191120,543039825777,15424142725,1446103257,10781914417,78454478,553821740194
20191119,542721380946,15358198943,1459432483,10980386765,88401247,553701767711
20191118,541533326643,13134767176,1488430040,10960017504,98174137,552493344147
20191115,541112917831,13435659119,1458053476,10748849005,85193088,551861766836
20191114,542725646617,14366003115,1498391565,11132049828,128526310,553857696445
20191113,542048023809,13852658050,1466268483,11005876873,107378800,553053900682
20191112,541360163467,12473968511,1463070655,10823777899,100984321,552183941366
20191111,541755441181,15099217868,1461309318,10797278670,94053832,552552719851
20191108,543255280042,17667708660,1468819140,11276338194,87545628,554531618236
20191107,544188094794,15533015247,1511237167,11468432102,93689274,555656526896
20191106,543999526706,18100800898,1505732872,11336704592,104254943,555336231298
20191105,544029029680,20647451367,1490498916,11272890053,109679915,555301919733
20191104,543020295419,19072530921,1477482548,11102164516,106053387,554122459935
20191101,542675980074,17180068941,1438066541,10900927115,120952284,553576907189
20191031,543040299737,16337590425,1410433123,10638733181,83389350,553679032918
20191030,544449761544,16601238273,1411563382,10709021205,88463226,555158782749
20191029,544786863040,19133429352,1413383183,10781082019,73172280,555567945059
20191028,545352851087,21208661643,1428472367,11152393907,107814186,556505244994
20191025,543351773604,16219438581,1421799599,10884799198,98662974,554236572802
20191024,543586678053,13490893210,1464298004,11123544614,94452075,554710222667
20191023,542590711121,13060167801,1494568237,11454460632,114905572,554045171753
20191022,542455008256,12180569383,1471945881,11389398387,106659390,553844406643
20191021,541719877028,12901676433,1478047177,11605583690,152331489,553325460718
20191018,541397950787,15610291452,1416633891,11593501055,90305609,552991451842
20191017,543067159580,13069190384,1450008002,11897000318,94145421,554964159898
20191016,543790595150,17094350249,1435668069,11801770937,110512436,555592366087
20191015,543677569235,17158825976,1407774789,11632742534,90616662,555310311769
20191014,544165541216,24627094056,1419701966,11768306187,143525090,555933847403
20191011,541053440557,18600737480,1376478811,11333591582,129383565,552387032139
20191010,542411429535,15468876503,1350734096,10968253874,129787210,553379683409
20191009,541990984143,14806074032,1317712247,10556972646,126396777,552547956789
20191008,541173606913,15009332373,1295605912,10309531518,152761867,551483138431
20190930,538791089316,11159059828,1186057417,9673381768,59103589,548464471084
20190927,543547417610,13651850239,1213305033,10023846611,70419158,553571264221
20190926,545878128202,19967035191,1265815151,10324609064,106584955,556202737266
20190925,548262512825,19432741019,1278222915,10617077202,104172494,558879590027
20190924,550171649766,21762642549,1307153522,11030268233,135674600,561201917999
20190923,550826508305,20355243063,1289798619,11113215890,107393054,561939724195
20190920,550048535904,21047597684,1305998118,11211639118,104270516,561260175022
20190919,551374200309,20221899437,1297632816,11126705421,113250029,562500905730
20190918,550256286908,19795887161,1289918069,10876374112,126833738,561132661020
20190917,550022693898,25772659094,1290581159,10708483273,109022546,560731177171
20190916,549029500599,27385289134,1348217184,11563030260,107602149,560592530859
20190912,545974771941,24176204399,1319236084,11466782528,112502594,557441554469
20190911,548131519774,29042011279,1331203666,11779733982,126601652,559911253756
20190910,547266110610,30736436518,1298127628,11568303313,91928439,558834413923
20190909,545831543383,33206188633,1321451189,11660197020,114199560,557491740403
20190906,541315600123,26293719864,1290768095,11412789332,103181090,552728389455
20190905,542059512654,37240645540,1338815746,11612179656,155392513,553671692310
20190904,540978840534,26488975420,1329165907,11362719294,128421553,552341559828
20190903,540321825192,22468521154,1310412878,11393615940,101610598,551715441132
20190902,540259932065,23631868473,1316124034,11117993360,128363956,551377925425
20190830,538541616594,22533030608,1287987192,10896705119,116966660,549438321713
20190829,538787831176,19236034328,1273930144,10746547843,106985030,549534379019
20190828,537103608725,19240666348,1262211505,10620620315,103369133,547724229040
20190827,536284871635,22019856026,1273757036,10806763690,132884721,547091635325
20190826,536544973668,19098662590,1235033574,10455657926,74670660,547000631594
20190823,534954183704,18010394142,1271403756,10741650800,108639041,545695834504
20190822,536149988643,16082314254,1261844075,10655540918,118751026,546805529561
20190821,535653416579,17490915722,1250150460,10616857288,101681380,546270273867
20190820,535069125138,20899546691,1247511110,10579203659,114427771,545648328797
20190819,534798962347,26933254389,1254363131,10686571813,159242978,545485534160
20190816,530938203843,16881484324,1196544697,10027664791,87327235,540965868634
20190815,531287578318,14891693054,1240529823,10700550002,111183092,541988128320
20190814,532093964720,15677295712,1268795072,10702727543,89760929,542796692263
20190813,531855170860,13638202516,1287855952,10727861522,99611437,542583032382
20190812,531567416332,13712223731,1275695226,10651297822,126034467,542218714154
20190809,531240738575,13155759330,1250342572,10236133794,108385987,541476872369
20190808,533481575844,13634118004,1255018288,10314485611,161742765,543796061455
20190807,534335401053,12558575199,1194277650,9675984001,150927008,544011385054
20190806,536449029000,20041599701,1149549985,9413801749,153501028,545862830749
20190805,539088661040,16607158292,1146632548,9582530513,120673626,548671191553
20190802,538926998030,17383366860,1132426423,9369483734,118873439,548296481764
20190801,540682032669,14062984366,1141559572,9337139934,87049977,550019172603
20190731,540746046599,14389532212,1182610070,9467471922,117909562,550213518521
20190730,541192071940,16118821650,1168070497,9347245715,84424563,550539317655
20190729,541103076216,13361287667,1204297265,9244310333,115389393,550347386549
20190726,539752245878,13373392102,1168169545,9032162431,90970023,548784408309
20190725,540617344435,15146953154,1162817489,9006643170,102442845,549623987605
20190724,540838721429,15440730004,1141817461,8637550851,123257848,549476272280
20190723,540885652598,11409695835,1098235097,8158033022,80812728,549043685620
20190722,542317389721,14395752888,1106159587,8069299105,137249689,550386688826
20190719,544117046863,14190650518,1052285915,7363938242,89660833,551480985105
20190718,545891094423,13360574455,1064147607,7356311165,98255887,553247405588
20190717,546770795139,15127279382,1080888260,7489499813,116911675,554260294952
20190716,546419207751,12932999579,1054555117,7406653782,65030217,553825861533
20190715,546829583252,18209150660,1112046313,7795615787,141967109,554625199039
20190712,545292920109,12969227189,1096069461,7599876580,94597817,552892796689
20190711,546736009397,14226296727,1109233054,7643212116,99253840,554379221513
20190710,548502478946,12920602089,1090137163,7475127328,92449347,555977606274
20190709,548742383856,13913309898,1066690610,7361346957,104708251,556103730813
20190708,549280291963,20109650621,1058149163,7341049956,132458406,556621341919
20190705,549758208389,15440449145,1042673926,7472703152,88688427,557230911541
20190704,550607512075,19205073061,1080378656,7626456053,128917227,558233968128
20190703,550488925077,22292827567,1057887153,7532852077,106703379,558021777154
20190702,549329550799,22732924143,1070295430,7651458132,130462802,556981008931
20190701,548115136533,32105800133,1028740679,7576365455,132993596,555691501988
20190628,545403611820,18258359192,1030666659,7264107771,129999733,552667719591
20190627,547617686319,20769366046,1027275946,7464304394,140430572,555081990713
20190626,547799690532,16138911252,1006264828,7067117009,133504885,554866807541
20190625,548267174410,26105690652,981551948,7139459583,133199467,555406633993
20190624,546922849389,22879628999,1001018406,7198066420,123305254,554120915809
20190621,544809211659,28470399947,994752927,7193834165,124591015,552003045824
20190620,545474733422,31754452247,1027993970,7404871184,184789927,552879604606
20190619,543194212320,23848713859,1003074026,6881742813,129845601,550075955133
20190618,543689979601,11716363393,977683089,6524573678,79056895,550214553279
20190617,544906059569,12824537522,993238362,6511776511,112758057,551417836080
20190614,545365849561,17408020785,971139534,6284329054,83694657,551650178615
20190613,547506113249,19409203739,1005400217,6543232826,123215412,554049346075
20190612,547092700496,23698474021,988439381,6421699821,111584322,553514400317
20190611,546076092112,25901923830,1020279068,6708242864,201308603,552784334976
20190610,545807399551,15159958602,981763208,6179611385,162767345,551987010936
20190606,546661467639,13792663864,897720602,5755371448,87563151,552416839087
20190605,550165203687,16165738275,942753721,6173462807,112172863,556338666494
20190604,551845445249,15042718343,912723203,5919666354,83076207,557765111603
20190603,554095723600,17940023324,958029201,6231060446,111540759,560326784046
20190531,555440566101,18170958432,961147010,6234483391,126671619,561675049492
20190530,557674222555,18748916524,955597546,6253137384,125869094,563927359939
20190529,558801967110,21451472742,956178757,6358911393,128723984,565160878503
20190528,558474984580,21929366388,950773602,6271102872,152580994,564746087452
20190527,559792435668,21454269577,925445031,6148749960,171337468,565941185628
20190524,557750049494,14975157319,884355253,5794135953,109930151,563544185447
20190523,560527552182,19064612978,930593681,6018286664,144633497,566545838846
20190522,562387964684,18996661933,933739619,6091053275,138323736,568479017959
20190521,563899124599,21242688734,935508281,6100228979,179909198,569999353578
20190520,563258751070,19776457362,892524358,5805947974,156738712,569064699044
20190517,563665781997,23159994350,886002209,5818970670,120129193,569484752667
20190516,567049805145,24093237882,958825357,6395954054,171757618,573445759199
20190515,566600704440,24966930292,921570194,6144535731,176197075,572745240171
20190514,566964503072,18778651271,878326362,5765841597,148113962,572730344669
20190513,567689658746,20305925919,857051228,5682066267,130740783,573371725013
20190510,569552302327,30290064958,889334532,6046023197,220537499,575598325524
20190509,570455002203,18741470576,816305544,5358468045,124007307,575813470248
20190508,571057518334,21222830163,855384607,5667420255,159184127,576724938589
20190507,570866704572,23222772103,849974346,5755159556,163480079,576621864128
20190506,573185674230,32207427307,856577217,5703020317,194509051,578888694547
20190430,577865182474,21312609774,848859248,5966965402,77741753,583832147876
20190429,585302832156,26035623014,961419760,6637515223,158269812,591940347379
20190426,589923831402,29060795668,935585438,6546971604,106008294,596470803006
20190425,591947751543,33493414729,1047143113,7179957493,140383428,599127709036
20190424,595388886472,34168495627,1066587240,7468238475,121951414,602857124947
20190423,593401459965,36853749447,1093288720,7654827292,157274131,601056287257
20190422,594831558594,48086084184,1092875237,7712007391,155567650,602543565985
20190419,591196274296,42365440576,1082800723,7821050157,139821138,599017324453
20190418,591175252232,41409359321,1088724076,7760487190,121886392,598935739422
20190417,589911050836,43694908636,1086266189,7774800992,145639001,597685851828
20190416,587420822124,46426809950,1090319316,7841722599,212919418,595262544723
20190415,583299208979,44636372612,1090692110,7643113739,212024206,590942322718
20190412,581164513945,33700743868,1022500698,7298662903,141754049,588463176848
20190411,583208143243,43791954590,1049665764,7516621319,128656884,590724764562
20190410,584052810698,51270632794,1101505220,7976475409,183961543,592029286107
20190409,582591393394,49975237698,1082387455,7893889401,164489669,590485282795
20190408,579824640228,71019531166,1126245742,8077000019,214981056,587901640247
20190404,570001321985,62428623909,1066403269,7896289622,156663359,577897611607
20190403,569552117271,58245986188,1085896199,7994854942,191522831,577546972213
20190402,566121855650,61545143289,1060360344,7705881744,150022768,573827737394
20190401,561244963862,63290251721,1108578403,8010959023,219114881,569255922885
20190329,555919750875,47821612832,1039055432,7371057196,219567226,563290808071
20190328,555438962621,34646709708,1037645116,6993676803,152641236,562432639424
20190327,555908994882,34574191606,1028108624,6988136999,151229050,562897131881
20190326,554043266609,40209100807,1012826904,6844617743,131856288,560887884352
20190325,554217910683,48629467519,1078683267,7330480585,155011853,561548391268
20190322,549160945947,44500433858,1081840699,7491446372,145828715,556652392319
20190321,549423715029,53670381879,1097401915,7635981051,164607739,557059696080
20190320,544227583847,44045275616,1095769302,7565770022,170697567,551793353869
20190319,542161873286,43941414651,1074513188,7368346110,132076009,549530219396
20190318,538936145587,49192353470,1082601950,7490082590,187111696,546426228177
20190315,534927567528,41487210170,1028114404,6935786537,150483804,541863354065
20190314,535868334393,40374818674,1022162056,6809600412,135403005,542677934805
20190313,537118191110,55850100494,1069952552,7150452732,175762015,544268643842
20190312,534177143108,62158744961,1074156481,7378951309,195309393,541556094417
20190311,528539041036,51014326360,1039732965,7081333275,187655596,535620374311
20190308,519973258458,60296306570,1030756129,6952524243,135365618,526925782701
20190307,519397678384,71739590059,1106234957,7681681754,168824246,527079360138
20190306,509414858080,65730782793,1152119892,7873221114,204309161,517288079194
20190305,499610506952,50007817140,1115309507,7526294846,144120423,507136801798
20190304,491719613594,61979499206,1126548442,7567714697,204847024,499287328291
20190301,484550188993,36818605234,1042939744,6972755094,133443657,491522944087
20190228,484555495642,34284100277,1038693321,6802372203,101264475,491357867845
20190227,484549266902,51742607833,1072246554,7058566556,139523339,491607833458
20190226,478155076613,61778381795,1081794097,7165801337,133725527,485320877950
20190225,472704160094,60257058289,1122819511,7439612565,200638905,480143772659
20190222,461954859629,32419548758,1048598706,6633130375,114939138,468587990004
20190221,459234809159,29335136538,1069181895,6528489311,133286029,465763298470
20190220,457184818881,23002027138,1046478607,6310806597,111531397,463495625478
20190219,455192743990,28625386942,1023843169,6260721866,95927415,461453465856
20190218,451906400957,25117598055,1049513154,6391062117,131952212,458297463074
20190215,449451785567,18711205768,989257449,5736632641,62770838,455188418208
20190214,447472501005,18337413351,1023600324,6088145915,72213938,453560646920
20190213,445877866753,23431620671,1034361568,6129272703,128903463,452007139456
20190212,443198997474,16272580034,989411843,5745346454,102740624,448944343928
20190211,441723272260,15233912673,961380232,5560296496,84886710,447283568756
20190201,438481618486,9167907563,900773251,5144864769,31657502,443626483255
20190131,444603342646,10652745126,942170266,5291350496,58254087,449894693142
20190130,447513860371,8176777752,964352754,5401332274,39910790,452915192645
20190129,449290368941,10847545001,1019826473,5698281406,75864009,454988650347
20190128,451157215423,11655037680,1038172701,5829807368,64843482,456987022791
20190125,452458688565,11015660718,1048273318,5889191154,67776226,458347879719
20190124,455891899209,11851467748,1051420369,5946914033,67123886,461838813242
20190123,456649149578,9593360205,1052008371,5832369934,56171399,462481519512
20190122,457169620037,12374675830,1057968944,5848841730,65296518,463018461767
20190121,456096234282,13498362054,1098121269,6168221783,74371675,462264456065
20190118,456668089943,14120002196,1104573323,6158543944,89668703,462826633887
20190117,458623130349,12779748834,1136406351,6214380734,84602763,464837511083
20190116,459037993700,11569730459,1125879640,6206006131,73966702,465243999831
20190115,460338181685,13309807755,1130232218,6283407281,103821564,466621588966
20190114,460947518023,10515099617,1136296781,6152103839,68758482,467099621862
20190111,460323775055,10693099107,1135891303,6193426510,74373837,466517201565
20190110,461532461893,12334029026,1135095637,6192451286,62726774,467724913179
20190109,461689424168,15835508236,1182093297,6378866662,119948522,468068290830
20190108,462472442828,11671232442,1158266222,6248209523,82313082,468720652351
20190107,462458355219,14233893206,1146589074,6202011515,85494668,468660366734
20190104,462250410730,13853868136,1120988370,6000748759,86298981,468251159489
20190103,461887281000,9187520553,1122021818,5854923494,79531121,467742204494
20190102,462351753650,9073727044,1098468832,5714014114,59090736,468065767764
20181228,461987376518,8230524637,1122525820,5807127861,64719099,467794504379
20181227,465434791784,10297963054,1167340231,6010134313,83213099,471444926097
20181226,465856293975,9000312721,1141877019,5920976211,84598375,471777270186
20181225,465977437816,11198667482,1140607373,5928863416,119637128,471906301232
20181224,466694612238,8058286210,1129879688,5942677972,94574734,472637290210
20181221,466520920169,8910954619,1095555834,5785523079,56456627,472306443248
20181220,467700056854,10660245549,1135546063,6036356598,81714578,473736413452
20181219,466785517266,8303447450,1153880970,6137428055,55914775,472922945321
20181218,467607913280,9500577283,1190228294,6372120420,80386476,473980033700
20181217,467686247128,10124632791,1208953478,6525530228,71970641,474211777356
20181214,467350549615,11184369207,1206872259,6547021947,72131272,473897571562
20181213,469359024408,13842831461,1250503052,6963324308,111139010,476322348716
20181212,469095178379,8481922578,1220605365,6694523570,66607188,475789701949
20181211,469293601471,8066600259,1205497431,6605861080,60569806,475899462551
20181210,469640781271,9392252034,1242843037,6695463184,85699396,476336244455
20181207,469305526326,9143076755,1224191048,6759226739,57060322,476064753065
20181206,470166691402,13740797451,1253819112,6875567625,95360789,477042259027
20181205,469009226480,13499366103,1263649962,7160856135,92081478,476170082615
20181204,469135276155,14808620158,1276013784,7242872772,87965523,476378148927
20181203,469245598003,19418344647,1283051737,7229588572,107693093,476475186575
20181130,468743399761,9849274010,1250397028,6859536436,87240526,475602936197
20181129,470522757696,12564996083,1250901857,6830567716,91752563,477353325412
20181128,471762479372,12021271672,1247923056,6923062423,83969136,478685541795
20181127,472518416397,10311147295,1258106746,6921498998,79656181,479439915395
20181126,472356414911,10603880737,1264099730,6857826040,118938280,479214240951
20181123,472689959467,13603404960,1210229320,6617169688,67836185,479307129155
20181122,475446195531,13029992143,1274394701,7127088124,130992636,482573283655
20181121,475233531812,15593288878,1217818709,6935754162,95112993,482169285974
20181120,475056211230,19727286603,1233373349,6950610858,98962184,482006822088
20181119,473853869819,22508046500,1228421574,7184138720,95842193,481038008539
20181116,471864498649,21651038537,1217168780,7106374624,82199523,478970873273
20181115,472299226346,17736388343,1269815834,7306742853,114308897,479605969199
20181114,471116952401,18183832857,1273677370,7124584991,106882673,478241537392
20181113,469651112918,20293806356,1273148543,7266641493,117261606,476917754411
20181112,468798812385,14356508015,1277396554,7085752463,104013068,475884564848
20181109,467006411052,11625464457,1247177983,6821653091,72131065,473828064143
20181108,466765910615,12385496362,1279949635,7064055157,112574016,473829965772
20181107,466902793065,14621002708,1266860357,7021329203,103129340,473924122268
20181106,466581343674,12923212376,1268341140,7093425549,102326506,473674769223
20181105,466115042931,17349425406,1272137473,7133329443,94767119,473248372374
20181102,464828736776,19849091432,1282758417,7219800758,117875872,472048537534
20181101,465870071113,17137760322,1286620052,7110507259,117357218,472980578372
20181031,466160156064,14153148211,1281834514,6996687698,116379112,473156843762
20181030,466687049647,14558310220,1277613102,6837184270,139169130,473524233917
20181029,467955868930,12025543449,1230224918,6531241081,85497954,474487110011
20181026,467169473732,12558394091,1244214719,6664265205,86679903,473833738937
20181025,468119435880,13668498858,1260912387,6836314483,111500191,474955750363
20181024,468452250683,14172966361,1265720892,6860620570,144239474,475312871253
20181023,468538487733,16983554594,1217649813,6631903685,115056142,475170391418
20181022,467650052315,20309061131,1243599189,6791075394,156385311,474441127709
20181019,466894473017,11285156917,1195996714,6232229493,109652823,473126702510
20181018,470159311394,8745084559,1185207610,6043042341,89550148,476202353735
20181017,472763724975,10739959108,1169827708,6137710907,95738444,478901435882
20181016,475305265051,9694959177,1169119221,6065648758,98620186,481370913809
20181015,479708528447,9157493390,1163912245,6092805129,91507386,485801333576
20181012,482668130673,11922965049,1133265783,6079655317,108646344,488747785990
20181011,489362003478,15297236005,1128217682,6030483129,104965230,495392486607
20181010,496692130111,10218445695,1126496935,6500221990,70941838,503192352101
20181009,496798379422,10432337592,1119629924,6530696251,75195563,503329075673
20181008,496333847498,16604993961,1097207895,6373994495,69433659,502707841993
20180928,492989890192,11449499099,1101661217,6579183795,58705161,499569073987
20180927,497647547449,11426969305,1127435606,6625016713,65247485,504272564162
20180926,499093628658,14668100299,1143858629,6803855948,116614737,505897484606
20180925,499653250243,12021682276,1100679121,6508750346,64425761,506162000589
20180921,498777152833,14696528658,1119878493,6719384774,93752742,505496537607
20180920,501271444915,9394648535,1114851206,6578365657,53490103,507849810572
20180919,502678815221,12564942247,1136684605,6653614608,114817339,509332429829
20180918,504631339773,11111861194,1120709601,6504278160,128132152,511135617933
20180917,504993237974,7289053681,1067253779,6134288971,63432849,511127526945
20180914,506009498734,8382618687,1056096083,6177933709,79063831,512187432443
20180913,508467827596,10491937857,1042908465,6142824037,79973742,514610651633
20180912,508765532668,8002677463,1033696345,6078028399,53396585,514843561067
20180911,508866481182,8123435533,1046904337,6189182779,66991260,515055663961
20180910,509479248423,8875075988,1071833210,6281188399,71392454,515760436822
20180907,511137883134,9921058468,1062173109,6369394369,67828582,517507277503
20180906,513256982251,9608460313,1078807739,6381320737,71344598,519638302988
20180905,513010193653,10053210464,1085991423,6412329432,71523337,519422523085
20180904,513182458484,11223222793,1068453907,6537663165,62339495,519720121649
20180903,513290990055,9043222146,1060669960,6395865599,58590497,519686855654
20180831,513956376664,9304499170,1041817390,6267288303,65117617,520223664967
20180830,516491992705,9908792121,1046450904,6351537378,55828287,522843530083
20180829,516904203797,9502132118,1040329134,6431264111,54132688,523335467908
20180828,517411048779,11740251929,1042957607,6441768720,59946345,523852817499
20180827,517733060699,14074148451,1054301900,6523414365,76750583,524256475064
20180824,517564307970,9256500111,1055434513,6378304598,75249287,523942612568
20180823,519453159802,10581583524,1048043683,6383123967,70671234,525836283769
20180822,519198247652,8808470525,1043049813,6316111281,56607463,525514358933
20180821,520047585196,11255287603,1062396663,6419033360,89835700,526466618556
20180820,521423369451,10005551727,1035044381,6208372544,80791652,527631741995
20180817,522737305344,10584388929,1014558196,6015570649,71621983,528752875993
20180816,524345738232,11552028924,1032619516,6203281111,83446586,530549019343
20180815,523990050346,11141066644,1036372243,6247687582,95509976,530237737928
20180814,523860576227,10256594514,997632903,6203418052,69657655,530063994279
20180813,523722819418,12671000229,986627009,6164675703,72899310,529887495121
20180810,522761979654,10717952130,986127819,6135874304,49297801,528897853958
20180809,524594839263,14142305620,1017778368,6338098485,90919810,530932937748
20180808,524900753790,12148588753,1041480966,6241793362,95724617,531142547152
20180807,526392695026,13647402301,1032783849,6336605165,124365541,532729300191
20180806,527221789894,11333112080,984292383,5923876449,87366585,533145666343
20180803,528810410344,10333969639,979960703,5914439526,81369704,534724849870
20180802,531174597926,14845841305,979244277,6029617951,83721012,537204215877
20180801,532068228664,14136774587,1005192029,6390027018,100488448,538458255682
20180731,532916979958,10350154724,968005836,6323746312,66856262,539240726270
20180730,533625257352,13499201549,960098751,6323144046,69563110,539948401398
20180727,533848926644,11868522985,951447265,6307997397,58855822,540156924041
20180726,535637045599,15646868964,968261754,6388379072,81111324,542025424671
20180725,534356990639,16247928748,997355779,6477483650,102713437,540834474289
20180724,533653883014,23085285680,960253394,6382280611,93078625,540036163625
20180723,534001675133,18718068986,974263080,6397855276,123205923,540399530409
20180720,534906513435,14671769781,935063064,6136873656,102540870,541043387091
20180719,536935848153,11438197205,919889220,5878888200,93128766,542814736353
20180718,538559054640,13026577818,899604354,5811492042,84462991,544370546682
20180717,539103125579,12094301625,887877888,5727286398,82144955,544830411977
20180716,538527240085,12420489520,900435462,5861316303,79501499,544388556388
20180713,538340528874,12579504304,904611252,5820349633,68637546,544160878507
20180712,540247707295,15746282870,918580058,5941896813,88124579,546189604108
20180711,539487029849,11414643702,923002288,5788339371,98760946,545275369220
20180710,541878346674,11889884588,923428291,5966656000,88033139,547845002674
20180709,542012974350,11893969265,910092256,5839181315,102767274,547852155665
20180706,543489414407,12896260866,877989836,5537590785,100828306,549027005192
20180705,546020776894,10580490356,878072509,5496431511,100017594,551517208405
20180704,549414701907,9905878496,867513571,5493794460,100734396,554908496367
20180703,552690105369,15247081510,854343505,5506176897,118558812,558196282266
20180702,552525463016,13822745385,853159487,5458416822,115421849,557983879838
20180629,553522416883,13029951416,819402647,5436131119,99427264,558958548002
20180628,555085668675,11535268881,824047977,5240011996,79984555,560325680671
20180627,555886983956,13003328483,841997865,5380856938,115157843,561267840894
20180626,556636105493,12576291197,789178423,5190087507,74059593,561826193000
20180625,556875334203,11757098952,810587352,5258259159,99921430,562133593362
20180622,558196136785,11381925807,760970157,4965075587,58778229,563161212372
20180621,560808688544,14801185938,810695305,5173590371,115815936,565982278915
20180620,564645936794,14020014696,752501046,4975410577,71138015,569621347371
20180619,567849953722,19075444718,803183785,5227368870,133522454,573077322592
20180615,581569561529,13870458115,761565618,5203729466,82037661,586773290995
20180614,586589031060,13899414423,766844975,5357453951,104221319,591946485011
20180613,587140793988,13060641153,721178966,5164104663,70725188,592304898651
20180612,588519533549,15173608534,732589169,5296550864,84532721,593816084413
20180611,588485005458,12811528887,709750001,5065021647,71841306,593550027105
20180608,589088015126,14348962045,687568477,4922931680,60109192,594010946806
20180607,590959804095,16991538468,714880103,5184910940,66320004,596144715035
20180606,590709945434,15375328504,706324292,5119333953,71699058,595829279387
20180605,591074705741,15907349459,693717597,5049180803,64045536,596123886544
20180604,590840188900,13965747617,697119312,4899141075,76890586,595739329975
20180601,592445445276,14018863627,679398928,4799782262,64251426,597245227538
20180531,595372987763,16761954362,678091971,4846718115,73765112,600219705878
20180530,595635486365,17126411578,664925295,4667892780,72201621,600303379145
20180529,597965012117,17611399398,659521980,4817925876,72331953,602782937993
20180528,598949037435,16829970023,637365163,4694646611,55866482,603643684046
20180525,598455827921,15692437026,621890648,4599410124,53232829,603055238045
20180524,600564172688,16063644818,626126474,4648493040,58069877,605212665728
20180523,599797085094,20767927369,620918898,4664544356,62945590,604461629450
20180522,597985960989,20130655107,627590561,4738431993,66217588,602724392982
20180521,595880340436,22954339139,639878127,4774908811,91042411,600655249247
20180518,594145598040,17450293668,623244085,4611049856,90639341,598756647896
20180517,595158136870,14970481628,609938641,4453809437,74778911,599611946307
20180516,594416330170,18589326461,624035744,4596491045,82670037,599012821215
20180515,593410196752,16843274130,615080747,4605082468,78345394,598015279220
20180514,592905263679,17647263423,613708054,4573646168,86415258,597478909847
20180511,592719427747,17227451352,603532099,4392449312,74526602,597111877059
20180510,594735071550,18640720276,616132570,4548945214,85473140,599284016764
20180509,593703956355,16553893663,606024654,4444716543,84683609,598148672898
20180508,592400524194,20998883416,662332921,4722284750,149281168,597122808944
20180507,591629638695,19854191481,588025721,4410626492,100528562,596040265187
20180504,590434735762,15158223349,586810896,4228599065,98736108,594663334827
20180503,591987078108,17460205873,559667856,4185001993,84167918,596172080101
20180502,592911559958,17814502974,576827570,4128773924,99870623,597040333882
20180427,592867415552,18335751591,530572059,3973500134,61458180,596840915686
20180426,596178122764,17853488136,546411881,4068722777,61633457,600246845541
20180425,597019402304,17402108733,556651252,4191882772,66085362,601211285076
20180424,596377635708,20668951583,578747468,4297552965,102620337,600675188673
20180423,596995595435,17269095574,577099428,4153763852,86147091,601149359287
20180420,596545372671,18648208020,578160438,4227127835,97231955,600772500506
20180419,599180521526,20126295238,575995599,4345560275,100439088,603526081801
20180418,600098082128,20640351247,572480773,4211713806,121604143,604309795934
20180417,600284382263,18703544217,553977154,4090618073,93695430,604375000336
20180416,601024882857,20552602328,579311344,4284273761,104403224,605309156618
20180413,599833935982,16441860274,551694653,4227629771,73493670,604061565753
20180412,600424988033,18548690772,547550452,4234501220,58490691,604659489253
20180411,599689679276,22023899412,568770358,4396595995,91789260,604086275271
20180410,599080845943,21979137912,578424038,4362450284,139240721,603443296227
20180409,599650337034,19593413352,525219014,3990578093,92769980,603640915127
20180404,598181552536,19443610928,489696634,3819740711,64327859,602001293247
20180403,601169419027,19661769790,500961705,3950267728,72416614,605119686755
20180402,601030714928,26034092292,545886858,4206509899,114597342,605237224827
20180330,598855912677,21090897971,501625650,4064850235,75362505,602920762912
20180329,600145215249,24031744677,539998095,4173749355,130956766,604318964604
20180328,599307494218,21615504204,538455045,4001345465,131261267,603308839683
20180327,599442144212,25598099415,497645258,3910564069,109508379,603352708281
20180326,597411337395,24175340823,483055245,3755175967,108943854,601166513362
20180323,593792703708,25850609555,512844402,3855268470,134572126,597647972178
20180322,603796655509,19824211088,487482347,3894306402,87921061,607690961911
20180321,603579457196,24618884450,524294541,4183191496,113223929,607762648692
20180320,602106366122,19071274527,503405374,4011255918,90705615,606117622040
20180319,601576470724,19786309333,521595800,4072476369,115183057,605648947093
20180316,600603525889,19655255713,477923762,3832651624,70720573,604436177513
20180315,601172365606,20560258426,513327141,4072190209,101371412,605244555815
20180314,600345441237,21844321789,478003419,3963230726,86252615,604308671963
20180313,599568767827,23243312776,482696631,3983416506,83299271,603552184333
20180312,600045856188,30147045291,499347672,4192577698,92955878,604238433886
20180309,597050145863,22987739737,517673800,4172074169,85716362,601222220032
20180308,597940210780,19508623178,513988371,4143832074,80078000,602084042854
20180307,596969079947,21333658687,576301732,4372211579,142019595,601341291526
20180306,597537104191,27621735488,527135417,4228810764,120845036,601765914955
20180305,595049930410,18212115131,513243849,3948000137,87456226,598997930547
20180302,595361568569,19133250564,483333284,3842126390,65974083,599203694959
20180301,595939917864,20597765093,502779091,4026257637,81985449,599966175501
20180228,594617162664,21297493208,519612772,4152781574,90028782,598769944238
20180227,593011785899,22856603849,515507218,4210700362,74280906,597222486261
20180226,592714977109,25753904633,539766801,4324525319,97710691,597039502428
20180223,590318411364,17836336744,538441060,4279690057,80715203,594598101421
20180222,590374192560,19397930848,537231638,4218365813,141429804,594592558373
20180214,587596708400,9746397185,428137439,3390879358,38697420,590987587758
20180213,595328087592,16338479817,481300156,3824705594,72708581,599152793186
20180212,600926938548,16839248965,481391892,3754839053,100772812,604681777601
20180209,604833557210,27580819000,466193240,3573356841,104990562,608406914051
20180208,615710148081,25870067541,466231986,3785537067,80582428,619495685148
20180207,616405478519,35263849592,489860104,4007914605,95806694,620413393124
20180206,619290275865,31544870755,510319945,4188948545,96446231,623479224410
20180205,630054975768,29843195422,514623809,4322740448,104110875,634377716216
20180202,631035437334,27287974198,473192696,4042598212,56031475,635078035546
20180201,636482319607,29702648663,502463110,4233708630,79415607,640716028237
20180131,645400680690,28966225507,483571589,4054638580,73671246,649455319270
20180130,648176166579,28745206171,478033248,4058242338,60408630,652234408917
20180129,648256047965,38181209245,501055416,4192740627,71491288,652448788592
20180126,646634615949,34247168309,516847971,4269286836,76289213,650903902785
20180125,647529134317,38141340740,533190722,4381538742,95255666,651910673059
20180124,646859187212,42616129855,542170310,4448193750,98229541,651307380962
20180123,644564213418,37876068321,540815711,4455055561,86183139,649019268979
20180122,639921300534,33237544268,542599432,4354081581,87925167,644275382115
20180119,636018905560,37339370592,554563499,4378780910,105099649,640397686470
20180118,634228438561,36979327828,552058099,4477045539,103608937,638705484100
20180117,627094987907,39842179516,567252405,4454773086,138072735,631549760993
20180116,625992542194,34078228867,503553012,4133975739,74508764,630126517933
20180115,621497637591,36278584789,569752152,4379791823,132724788,625877429414
20180112,619848249343,26368470723,506595130,4093318611,80954815,623941567954
20180111,621046744130,28156920753,518981283,4177520514,85734540,625224264644
20180110,619625092233,33230513439,515254713,4205771294,88968220,623830863527
20180109,616540107796,30086145554,492605694,4077347539,69350546,620617455335
20180108,614437310945,36490715414,520467167,4207633747,104853368,618644944692
20180105,611033498008,30311498312,475185679,3909520577,72649378,614943018585
20180104,610527948195,29696616884,473343923,3955106395,81062102,614483054590
20180103,608815534517,30439570182,448392069,3772954586,74917924,612588489103
20180102,608366051878,27590480172,441452197,3654085132,76344279,612020137010
20171229,605281700426,19021641781,450271299,3584861409,57296261,608866561835
20171228,607288414879,25351894785,478803994,3777150934,109419427,611065565813
20171227,604243378239,23203488414,445727861,3614363807,80882761,607857742046
20171226,603788870421,19751644607,475931044,3779155598,72584885,607568026019
20171225,602010826133,20835295949,522512747,3999879905,115968844,606010706038
20171222,600752458618,17813164425,486351525,3720772560,63490251,604473231178
20171221,601331057847,21436735962,497390836,3828819296,109017640,605159877143
20171220,600660765121,20341227305,481084040,3804967455,89601083,604465732576
20171219,601150771777,17601240193,454713106,3729730482,72507997,604880502259
20171218,600385416902,16374411672,483998594,3706518967,99663217,604091935869
20171215,599973160706,17498770920,482057036,3650059277,97333253,603623219983
20171214,601518600419,19549257497,533469985,4002821102,144729254,605521421521
20171213,599823623298,18141605058,501834433,3806754508,113866925,603630377806
20171212,598121141086,20096147911,511091337,3750354277,118763206,601871495363
20171211,597388285945,20461557664,486613322,3758638299,110323326,601146924244
20171208,595997613220,19042969089,470332997,3599879327,101508401,599597492547
20171207,596091122261,19581499313,440694265,3554247048,64305058,599645369309
20171206,595236819307,21596035758,460401742,3692154268,77544558,598928973575
20171205,594960743028,20791260681,474532056,3839705056,92330721,598800448084
20171204,604595733465,20604878464,458436496,3754415327,86365562,608350148792
20171201,605049876092,20725355751,443732783,3655974771,63388333,608705850863
20171130,606266729261,23568646067,478233162,3882969879,96504247,610149699140
20171129,606435086718,27404524134,499783242,4057232251,121540529,610492318969
20171128,605038393589,20423735751,440829702,3664336812,61488883,608702730401
20171127,604120318760,21706868377,458580752,3748916832,78489295,607869235592
20171124,607803783678,22821336538,452679647,3733474862,62007179,611537258540
20171123,612323609647,34971820282,509514411,4017733352,108387117,616341342999
20171122,613638975630,37463915477,503338160,4222736888,95749026,617861712518
20171121,610896888811,35670732307,502105836,4232326120,104388086,615129214931
20171120,606152968284,27606992716,493267595,4080179520,98061706,610233147804
20171117,605407313174,33437375721,518548935,4224948523,135303417,609632261697
20171116,611955170107,27540418339,480631120,4026241575,108925639,615981411682
20171115,610088191761,27322760931,496978150,3985367896,130081113,614073559657
20171114,609530393847,33110831866,469167041,4017520980,98235089,613547914827
20171113,607453853482,34795444594,492594068,4052282858,111469783,611506136340
20171110,602677946214,32745721664,438506907,3821670534,59189014,606499616748
20171109,602292882328,26156935189,454744258,3781100207,72398883,606073982535
20171108,599847626587,29447070709,456821400,3774348734,80880444,603621975321
20171107,597686940879,30488210444,512034410,3999307696,137849313,601686248575
20171106,593520002896,25570944919,462636701,3621227942,93081749,597141230838
20171103,589295810105,22065591152,465208697,3643067348,99391921,592938877453
20171102,591938582941,23159575658,465724210,3663595163,95949315,595602178104
20171101,593084233167,28705800913,491601782,3925298338,118625788,597009531505
20171031,589196036713,24791626758,448642962,3717369343,67355998,592913406056
20171030,587251583104,31576733592,444487721,3757667025,71427025,591009250129
20171027,586980537209,26446780229,420800673,3595627068,46881723,590576164277
20171026,585721846144,31351471515,435375661,3710445203,71269168,589432291347
20171025,579673158365,18360283874,420002329,3557791155,43331925,583230949520
20171024,578877370713,18074355996,459939221,3724863881,86145437,582602234594
20171023,580901689048,19180931506,414476802,3471614829,52887181,584373303877
20171020,578649055545,17650041440,407047661,3403723659,38321782,582052779204
20171019,579306498080,20408730538,428037151,3554960263,60065739,582861458343
20171018,581592266640,20201858871,437022324,3601203661,81025125,585193470301
20171017,584023686833,17522502561,431429615,3427935444,82068337,587451622277
20171016,583759038774,26676245565,419469982,3498468733,76783181,587257507507
20171013,582562628235,19444343723,431852830,3411703160,83506576,585974331395
20171012,583464735903,23778972170,493796248,3823521864,140285712,587288257767
20171011,583522843846,25301765202,470018575,3614850268,124366436,587137694114
20171010,583145677767,29129605458,406623289,3447916434,66838440,586593594201
20171009,578682092143,32575427391,419667372,3416567962,80668836,582098660105
20170929,570083581576,18403774027,360100589,3063587903,14008866,573147169479
20170928,578224273633,20793760783,409865399,3390141010,51576802,581614414643
20170927,579523451666,20346208626,421754694,3449274798,63125694,582972726464
20170926,579908899222,17279179734,446552178,3618066101,83655178,583526965323
20170925,581184044380,22333478459,432002233,3531429126,68455185,584715473506
20170922,583454267943,24426309561,434666915,3489006367,69237805,586943274310
20170921,586141235549,28857980931,476958094,3735971641,116527478,589877207190
20170920,587035104718,29680262317,427909653,3569458018,63043990,590604562736
20170919,583732774712,28638406338,432952665,3612825172,72239527,587345599884
20170918,582455107684,28778714421,421633992,3533098118,60464372,585988205802
20170915,578583374441,30565680178,417519900,3561335007,57302273,582144709448
20170914,579539655735,32442812362,457064747,3846801704,82227079,583386457439
20170913,577341861552,28360523868,457929864,3722482180,86246983,581064343732
20170912,575035344655,41786864214,441435522,3673940363,80203908,578709285018
20170911,573227491085,33037857460,444128822,3606202807,78307599,576833693892
20170908,568868703562,28649788248,424878279,3624195663,52202743,572492899225
20170907,568069058625,32232266300,459369706,3802840643,60695141,571871899268
20170906,567410040920,33756191922,491711558,4096511043,115941833,571506551963
20170905,564749751259,28356786574,471451664,3881841504,82912017,568631592763
20170904,563595774171,36864790689,439030201,3654909490,67574308,567250683661
20170901,560256965769,38145742306,466994763,3782081767,87809515,564039047536
20170831,559118232072,32852583691,456550482,3729686695,73372891,562847918767
20170830,554844843413,34243309804,496662229,3938428820,113980168,558783272233
20170829,553270011460,31750813945,459609720,3787373917,73107712,557057385377
20170828,550835572748,38739064545,510696772,4060209017,128456276,554895781765
20170825,546054164590,26559491663,474496552,3733950169,106115480,549788114759
20170824,546833583828,21677814495,486335871,3723296900,75922014,550556880728
20170823,545507089335,25055341612,462025804,3675940145,56642185,549183029480
20170822,544897323822,26957110928,458106227,3707097560,62929229,548604421382
20170821,543592415590,25636299098,440823957,3497726367,51042065,547090141957
20170818,541748509333,25742169645,451386830,3671141815,59752774,545419651148
20170817,542899045178,29645958008,477987355,3873410862,85823074,546772456040
20170816,540868472055,24284974967,468887425,3705165383,71078675,544573637438
20170815,539648893071,24658227869,475226886,3796690082,111023637,543445583153
20170814,537632596431,26457875922,431989793,3559045374,75469867,541191641805
20170811,535356477158,31093642271,436962483,3531912151,78369366,538888389309
20170810,537669007398,30265906808,464690682,3739686127,92464047,541408693525
20170809,537368647820,30620320769,463123550,3779979746,70474767,541148627566
20170808,534726199658,31299192096,462236088,3722134478,83054330,538448334136
20170807,535636198766,29644034898,435091290,3544692781,59775062,539180891547
20170804,532820207518,34969999502,437008131,3598484776,61343935,536418692294
20170803,534879944654,30336073067,426925095,3530499040,40101614,538410443694
20170802,532200383095,35890923633,472065238,3831086862,74644104,536031469957
20170801,529231018478,31492038816,475180744,3916761485,84229334,533147779963
20170731,528537955376,32291507628,471633144,3749653632,88647581,532287609008
20170728,524828764794,23129529881,449456313,3594552210,64850236,528423317004
20170727,526393111133,28928422645,456019797,3672126096,74871485,530065237229
20170726,525088165155,28506278901,462576384,3726364371,69221980,528814529526
20170725,523213040701,26338233274,483244526,3843321662,79139914,527056362363
20170724,521007125367,31436994720,479277623,3819562298,75105656,524826687665
20170721,516927360025,26921358014,458057261,3664013338,55729000,520591373363
20170720,516852513732,29596930867,472290910,3835233677,67664070,520687747409
20170719,516645095697,33265674928,481869654,3861512433,97240795,520506608130
20170718,513938473137,22721068351,448380362,3630727039,59196595,517569200176
20170717,513668732540,31415272249,486076940,3921384435,102895531,517590116975
20170714,515043617427,19950483266,449085041,3732434542,55274211,518776051969
20170713,517301034702,26124408643,465139197,3920547029,83985652,521221581731
20170712,515930473901,24077229893,451208565,3674563887,69123264,519605037788
20170711,515329239075,24113515410,465271857,3652257545,89902771,518981496620
20170710,515392194701,25753060357,436142267,3533303823,67990356,518925498524
20170707,513724680300,21183754356,420009815,3423148313,52979219,517147828613
20170706,514569648233,22940149474,439656585,3701107459,71571363,518270755692
20170705,514487818603,19417095332,407039229,3380513092,58945285,517868331695
20170704,513157610530,17950741207,409436897,3485847272,59544318,516643457802
20170703,512479572751,17371993384,389877960,3194858156,38596841,515674430907
20170630,511528278042,14427929374,396494485,3330077479,37369552,514858355521
20170629,513501965352,17037839509,434162777,3668495146,75301950,517170460498
20170628,513378917370,19369329421,444232943,3745049046,85900469,517123966416
20170627,511457728296,19127295534,434703015,3659056301,64898977,515116784597
20170626,511001191807,24254723706,436162084,3615355659,63454086,514616547466
20170623,507890577040,18637892129,415242201,3434845727,50993695,511325422767
20170622,509754526622,25381397798,459116739,3679412004,82011037,513433938626
20170621,508932378843,18008268671,439057871,3458382285,77624556,512390761128
20170620,508333054879,17080691207,419397848,3358812434,61152261,511691867313
20170619,508226930204,16232669045,426831377,3416889249,71546606,511643819453
20170616,507198520290,14650312612,414807682,3246556042,59247205,510445076332
20170615,509014686250,17179533078,416501667,3252054614,58364709,512266740864
20170614,507249153818,16798046853,441065903,3350887021,81079264,510600040839
20170613,506886152863,16110552209,432570511,3409027197,53929565,510295180060
20170612,505452993981,18015011225,451987256,3660929777,56335769,509113923758
20170609,504070812514,18706664816,444716537,3592199771,65656792,507663012285
20170608,505449167298,18952224217,426735099,3505035715,67177377,508954203013
20170607,504951018649,21295080642,414343909,3388251237,65755987,508339269886
20170606,502648994421,13568761087,447866841,3571713693,54533856,506220708114
20170605,502967461112,14819828169,465305755,3565840102,77451138,506533301214
20170602,501826004106,15446395167,455808499,3557897486,58337153,505383901592
20170601,502881436275,15656546673,486634160,3879315832,62154271,506760752107
20170531,506079239855,17477355035,470297887,3819410833,64687195,509898650688
20170526,505837079759,15608091455,479404849,3747120231,54388359,509584199990
20170525,509448789631,21641618054,526798065,4144147054,114121065,513592936685
20170524,509246104228,15052025458,540974469,4084972437,106494589,513331076665
20170523,509405303323,18273912915,523813690,4084368599,81487675,513489671922
20170522,512246774771,15648617871,512586026,3943705129,79594823,516190479900
20170519,513118335966,13744223490,476936675,3717253796,41331348,516835589762
20170518,514821195735,15739964577,493590589,3762927712,57542796,518584123447
20170517,514477174094,19530215983,507525428,3975605787,57080525,518452779881
20170516,513823056434,20398247737,524493585,4069617288,70225364,517892673722
20170515,512648970078,14169922128,527045623,4091657734,47642418,516740627812
20170512,514216422190,16141980020,532636804,4033272324,92045367,518249694514
20170511,517233414474,17818195260,511674349,4006363416,76433190,521239777890
20170510,522366049656,16913800523,527164831,4013054062,97212064,526379103718
20170509,525065572900,14802506208,477961076,3854767665,46586689,528920340565
20170508,525347761304,17661258004,510950712,3993596773,77930079,529341358077
20170505,528720181291,17642881394,492128168,3975583520,70570041,532695764811
20170504,532685207766,21326203514,494841508,3978450329,71709753,536663658095
20170503,531245801538,18307201838,488721074,3952918760,76819853,535198720298
20170502,531259620369,19054167988,467163116,3772831406,58206813,535032451775
20170428,530329667127,17646789342,442441225,3671006916,40160912,534000674043
20170427,533515685576,24547035898,478363323,3932938087,78172838,537448623663
20170426,533367272469,21271519456,500197656,3880363204,92953893,537247635673
20170425,533464968435,18205648475,490434136,3906328991,85108206,537371297426
20170424,534439269559,18627416369,496832358,3800943303,96017428,538240212862
20170421,538608445810,17034426828,454613394,3565027877,54522133,542173473687
20170420,543909595954,23378624663,475675681,3698528698,78574764,547608124652
20170419,545115793014,23401019016,495343117,3765069054,98903372,548880862068
20170418,546435281623,23858788054,504274062,3861892996,91867270,550297174619
20170417,546164795221,25427479080,505299918,3842612083,93761340,550007407304
20170414,544867962113,24989821214,509818438,3869038787,96423293,548737000900
20170413,547157833162,26347090124,562001793,4203291371,134339351,551361124533
20170412,544699793451,36239017710,536859860,4105700165,119745075,548805493616
20170411,543405620610,39238294257,517653541,4076179298,104226667,547481799908
20170410,539288405156,29553694476,535824965,4038400765,121327931,543326805921
20170407,537567404709,28121270901,502944528,3858152336,95871406,541425557045
20170406,539083167166,30020955275,530171797,3987295361,117641633,543070462527
20170405,538711252185,29640369957,476602630,3766704447,76420586,542477956632
20170331,535699641718,18508132159,473099490,3634290548,70702324,539333932266
20170330,539868684692,25347341220,499384107,3780142914,85869645,543648827606
20170329,541086656099,23524572352,557733353,4198738904,132555423,545285395003
20170328,540813227571,18673565474,504487923,3829041194,71959088,544642268765
20170327,540023946311,24213194147,514332643,3946526092,87670770,543970472403
20170324,537615245684,26140732123,519893856,4005834858,102982576,541621080542
20170323,537516709084,23094288813,543490693,4079025716,107641968,541595734800
20170322,536932700690,23446729286,542650229,4043393233,104908096,540976093923
20170321,535559713983,20023598664,541482778,4052216015,116874518,539611929998
20170320,534227970661,19660736723,494457663,3805301811,77614402,538033272472
20170317,532459710928,22348530287,517640400,3891214217,108052757,536350925145
20170316,532829101634,23318841374,502892302,3895170160,71113627,536724271794
20170315,529674658034,17217866925,536562774,3933798944,97679618,533608456978
20170314,528737903013,16667190566,511577456,3938830543,75715211,532676733556
20170313,528649018916,19181433874,526077356,3894708619,99878074,532543727535
20170310,527549728744,14551982050,513297363,3757623238,72574808,531307351982
20170309,529818259278,18223640546,510483270,3801715306,79065654,533619974584
20170308,530463329116,19129029367,555681475,3991511979,132238974,534454841095
20170307,530273177529,19485234256,491243853,3616213870,99350175,533889391399
20170306,529865824898,19035648329,493776623,3651107823,125493938,533516932721
20170303,527920521386,17751141610,445341587,3429794174,80359868,531350315560
20170302,530170254941,21211857140,457719608,3444258201,86960634,533614513142
20170301,529809697429,23292334150,491345625,3618715780,137602688,533428413209
20170228,528856868250,17727446342,436680068,3375593438,77633637,532232461688
20170227,527293793769,21363145133,435707217,3394063149,62601584,530687856918
20170224,525654220836,20653683582,442003649,3375705081,73231895,529029925917
20170223,525817689808,24686882954,463593460,3538553924,77599461,529356243732
20170222,523705409158,23833320262,466719650,3611107166,70124623,527316516324
20170221,522276159654,24195255065,552630286,4057502951,136474786,526333662605
20170220,521797169713,25567213705,535693977,3866762853,141555583,525663932566
20170217,517982129346,23551677476,531053784,3773835126,140709278,521755964472
20170216,518855552701,24226319951,497641495,3522402466,90600375,522377955167
20170215,516029816019,26582091963,577216411,3908627729,172808330,519938443748
20170214,514493589292,21279556607,465276441,3268476365,73376299,517762065657
20170213,512891126892,25494319077,474961612,3318538647,112808145,516209665539
20170210,509501164991,25684293331,410361347,3058976919,62794133,512560141910
20170209,510301910232,22663085338,400907979,2999102374,55866642,513301012606
20170208,507120995154,17527851456,409666257,2990431779,76546068,510111426933
20170207,505290510411,14733134047,412826548,2855342420,82443370,508145852831
20170206,505094124703,15607866098,375470591,2729574011,52236915,507823698714
20170203,501587053948,13012665745,352372799,2591392792,36738999,504178446740
20170126,498374008721,10368831308,334573344,2547782617,6634730,500921791338
20170125,505982240630,12266684836,377504073,2796884705,29154433,508779125335
20170124,507524064123,12326827603,390931193,2878112906,49957366,510402177029
20170123,510210195581,14558396547,396351948,2895853009,57943826,513106048590
20170120,511151354556,12168333608,388998751,2875530522,39181012,514026885078
20170119,513286356018,12150234652,446701660,3181768033,73466992,516468124051
20170118,514074153163,13462077516,479292071,3357240293,97458732,517431393456
20170117,515589498006,14304069471,459513260,3276346000,62246078,518865844006
20170116,516166619858,18744123693,468408987,3366270199,89447836,519532890057
20170113,528892909817,14808474716,434442382,3147160699,52882035,532040070516
20170112,533756166491,15745649736,449814088,3147374871,63277969,536903541362
20170111,535042445743,18902724719,464150097,3257103313,89826296,538299549056
20170110,536648846867,20212691796,466512102,3159415794,93465888,539808262661
20170109,537718895628,20095812115,451035138,3151701673,91852042,540870597301
20170106,537500878600,19869471573,418582234,2858333974,58039504,540359212574
20170105,539549321455,19822922714,432558412,2988885418,73640617,542538206873
20170104,540266946445,19600153246,411284970,2827996656,77535673,543094943101
20170103,541086585301,16133800643,396621694,2751779090,60364739,543838364391
20161230,541744074134,14344231540,445295507,2907720287,120410464,544651794421
20161229,546781977610,15751094213,374559216,2670847647,57849241,549452825257
20161228,547380152489,16009398832,382417435,2630404190,55373111,550010556679
20161227,546989121102,17809785774,375557145,2771776523,35705009,549760897625
20161226,545743760642,19619483085,418642842,2897953730,92797165,548641714372
20161223,544894505934,19043031252,400283208,2956020933,59553988,547850526867
20161222,548638718046,19296334236,420642645,2961458772,92968466,551600176818
20161221,549096724136,22122050674,402364088,3096966389,92112448,552193690525
20161220,548400035764,18737420154,392934181,2862197707,59466063,551262233471
20161219,547210251108,18200653755,403906740,2929726450,65519502,550139977558
20161216,547544828889,18239764248,412000314,2939297065,56281638,550484125954
20161215,549415404110,24392317065,443548145,3081793935,81333331,552497198045
20161214,547536309834,26484861643,465077218,3253930817,80933727,550790240651
20161213,545857484973,21736669175,457275910,3258606848,67786023,549116091821
20161212,545636500112,31162678070,517859220,3579624571,83839951,549216124683
20161209,552842108711,26820353251,538778789,3669446342,93808717,556511555053
20161208,554108985855,23898531152,519305685,3692335096,95894711,557801320951
20161207,553519950153,24070429642,489271972,3533985798,83557693,557053935951
20161206,552796495709,22502287281,486530914,3420881587,83049594,556217377296
20161205,552584304283,32964380204,503114693,3459620852,100734285,556043925135
20161202,552942591967,37792654678,495343851,3646377298,68000163,556588969265
20161201,555785149855,36512524580,552004472,3841995830,100266615,559627145685
20161130,553319387731,38009703417,506692809,3623238146,50799789,556942625877
20161129,550196731263,49413534718,544702721,3827897378,94585947,554024628641
20161128,546721796406,41134076209,572810333,3889652394,129391632,550611448800
20161125,541073208543,34030570478,501453341,3584196203,63936966,544657404746
20161124,541913908842,33906643087,567936112,3824549910,106844753,545738458752
20161123,541686542434,35396629202,526193407,3586996836,74331524,545273539270
20161122,542008130531,37589023793,542024944,3586448687,106051188,545594579218
20161121,538823020390,32816415500,510095248,3515686889,91673033,542338707279
20161118,535057333809,28680837457,505681128,3342644447,82417417,538399978256
20161117,536057751317,29092021043,519016876,3591333097,91203935,539649084414
20161116,535701347651,31599321935,482953798,3369798586,72436987,539071146237
20161115,532962827325,35512135262,476691015,3515075241,68217977,536477902566
20161114,530434954651,47161377775,496669558,3455894457,99913739,533890849108
20161111,524606038523,43717351669,482698727,3451229128,84919692,528057267651
20161110,524100406163,35916279752,486231069,3430919078,93839585,527531325241
20161109,520589849944,35512155182,462410746,3192679339,82817210,523782529283
20161108,517880324403,27167238686,462988347,3333262968,84189547,521213587371
20161107,517199830196,25675769223,442842002,3167668799,71740701,520367498995
20161104,515916361686,27702389256,412984066,3027101051,48299358,518943462737
20161103,516372674587,35185628006,432318559,3185394756,75471916,519558069343
20161102,512202186235,25005871992,405074419,2978091658,45269483,515180277893
20161101,512090091838,22527066066,405192780,2980140097,47955298,515070231935
20161031,510247896561,19877461369,394882433,2889058916,44174035,513136955477
20161028,508646408411,23432607213,414787502,2942339368,65997917,511588747779
20161027,512147647095,22057706294,394421882,2867404567,29135306,515015051662
20161026,511241718608,26837389154,446092326,3047214321,76024903,514288932929
20161025,509481313469,28013985325,399692664,2938692369,31563950,512420005838
20161024,506651209666,31973297399,433450220,3062310997,71104158,509713520663
20161021,502362504192,24048546481,419385750,2929633779,67679796,505292137971
20161020,502719680826,20264716528,396722645,2786501246,35699000,505506182072
20161019,502224582657,24632359171,402945727,2818854308,54739907,505043436965
20161018,501292033743,25202934394,392963150,2805307720,56407223,504097341463
20161017,498028728910,22216720236,420388098,2866511869,62002962,500895240779
20161014,496412883860,19548242666,422481098,2891899790,44694709,499304783650
20161013,497309822724,20303030805,438553008,3013468547,66699273,500323291271
20161012,495554017689,18404348514,406734625,2690801688,36990083,498244819377
20161011,493155823819,23454512182,418551097,2815512031,77300340,495971335850
20161010,490131918314,23559668411,375738521,2485754138,51608471,492617672452
20160930,485368046034,10947748818,363099308,2302076042,8089909,487670122076
20160929,492459294682,13966699339,397543343,2559643250,30521234,495018937932
20160928,493935142585,12346963447,449641915,2761111210,35129214,496696253795
20160927,494949863817,14803735855,462171998,2904498020,52782678,497854361837
20160926,495311007534,18398310421,476130925,2921256301,79824556,498232263835
20160923,495548458994,15777430126,443885874,2757532261,36732719,498305991255
20160922,497769188223,18424362327,449913652,2842252320,40987349,500611440543
20160921,498866810752,14949437717,446683649,2786995059,45304902,501653805811
20160920,498636196708,15176233151,448011985,2789447018,46584823,501425643726
20160919,497965398653,15970987319,458113075,2886141226,97715212,500851539879
20160914,496229314357,15678069181,399261828,2560130168,33751163,498789444525
20160913,499635099269,18045851868,426244384,2715487728,30621776,502350586997
20160912,499740145178,25293646673,465709861,2893896356,66451677,502634041534
20160909,501701136676,21402589584,456713699,2887751901,34540563,504588888577
20160908,503708906192,19861671600,464077236,2941733401,31236471,506650639593
20160907,503273563343,25787343636,486415126,3021243613,58620249,506294806956
20160906,503013816371,24868965139,466174782,2942855884,55852469,505956672255
20160905,500516748119,19738718257,470316954,2926669963,58457638,503443418082
20160902,499592197550,19720914539,477936580,3055378796,75347741,502647576346
20160901,501535695782,20956719333,464663438,3021949312,61126202,504557645094
20160831,501716007963,20539638820,445541370,2972281463,54635530,504688289426
20160830,501004637549,18127747375,459464394,2942132684,68741513,503946770233
20160829,501477435834,19262597443,433383078,2723176228,52040537,504200612062
20160826,499937745356,20244740587,413193125,2648511173,34680854,502586256529
20160825,500791792381,23464991931,440284911,2748060930,53762538,503539853311
20160824,500400801436,20520998519,437582114,2753149425,47004479,503153950861
20160823,499734417220,23174573771,442672350,2793503662,57331203,502527920882
20160822,499145177131,27494751512,428532762,2738433455,43399057,501883610586
20160819,498282428488,28438491033,420104549,2677317602,73765265,500959746090
20160818,498543748648,35091631592,403174145,2638732511,41562691,501182481159
20160817,495659051254,32177481153,411112441,2685725798,40993272,498344777052
20160816,493566088751,41889657998,425996915,2754629970,63014807,496320718721
20160815,486485232335,45599596654,456701529,2883440312,92273965,489368672647
20160812,479839424564,22006966793,465115409,2705740435,56541175,482545164999
20160811,480775762109,22024349627,487745002,2772890637,50664908,483548652746
20160810,480718943503,22612841898,482661441,2736885063,53461075,483455828566
20160809,479047204988,22848524757,460717073,2643024561,54921971,481690229549
20160808,477819998514,21430172220,462116396,2615946503,50381630,480435945017
20160805,476692801710,18678111692,441467482,2474642813,40057237,479167444523
20160804,477637950967,18769312405,445576381,2512008832,44262829,480149959799
20160803,476932091555,18468077204,434926411,2460715830,51204670,479392807385
20160802,476393053057,14878698033,411015899,2350121715,28426603,478743174772
20160801,476355670754,18019034247,418461422,2352431485,40136631,478708102239
20160729,478048309022,19644960366,412096456,2373197134,24671710,480421506156
20160728,480421749174,26674128603,430378718,2485031794,51024068,482906780968
20160727,482124688799,38181156047,438321183,2502229053,76538726,484626917852
20160726,487693941995,23503719129,422853429,2449075034,50838836,490143017029
20160725,486965174977,21623531740,402557515,2265389528,28996966,489230564505
20160722,485774399944,24165846980,396108001,2273696518,35511469,488048096462
20160721,487493320212,25317838648,418468884,2446552497,44999084,489939872709
20160720,486271452106,21205037443,408812651,2339523643,27612751,488610975749
20160719,485650291962,23944297057,411786317,2313343445,44047567,487963635407
20160718,483284066990,26067867176,411505500,2326851515,45236181,485610918505
20160715,481144294514,25326907353,392322171,2244011673,30810932,483388306187
20160714,482059531983,27102641122,418557552,2366026078,43634449,484425558061
20160713,481908335239,36678423531,423099353,2356322937,48346342,484264658176
20160712,482110757617,36821977122,476516057,2549096995,66672703,484659854612
20160711,479342990976,32614662316,479247541,2469632807,55737335,481812623783
20160708,478082382396,23389548398,471563001,2349687842,22199670,480432070238
20160707,480968164323,31988828163,508156060,2487269285,45517665,483455433608
20160706,480194633761,29106028080,491520521,2419211393,43624495,482613845154
20160705,478894481453,32734362701,478227617,2446240005,48180877,481340721458
20160704,477343099023,32130856359,460635630,2302250937,62146625,479645349960
20160701,473366707712,19675919674,434497231,2099563495,35646834,475466271207
20160630,474937137098,21467742218,442419821,2101251811,26303758,477038388909
20160629,475231804471,26788675844,447815442,2118405363,64276454,477350209834
20160628,473172010473,25173695721,414451274,2001696516,40340399,475173706989
20160627,472130992856,23847929426,439742629,1969519019,51126452,474100511875
20160624,469568272060,24668541492,430224808,1888549208,54843576,471456821268
20160623,470989946736,19023254037,431763853,1990896299,53017447,472980843035
20160622,471757473392,18476704112,402136318,1856200904,33557104,473613674296
20160621,471148810549,22369420851,408942965,1907486817,49486834,473056297366
20160620,471899642785,18147176614,400271759,1868935709,33731307,473768578494
20160617,471145006787,22059853838,392024143,1767669480,35213798,472912676267
20160616,472426696313,22911662035,417334456,1842035190,33767428,474268731503
20160615,472774017130,25071419447,444026379,2030176669,60139809,474804193799
20160614,469814782324,14488643361,455743898,2140904265,65977760,471955686589
20160613,470718833261,22065754739,430977947,1764666802,58834669,472483500063
20160608,472230941146,19223668206,425791006,2083247021,49710215,474314188167
20160607,474785801210,18687817684,423323012,1859507222,34423914,476645308432
20160606,474696463629,20389851290,406734589,1807091008,24680932,476503554637
20160603,473956396588,24400622414,400124553,1795161021,35727267,475751557609
20160602,475857307685,22727591932,400678010,1777461682,26956835,477634769367
20160601,473842939459,26853747104,389097930,1733878875,27907000,475576818334
20160531,472770517075,29411838246,399469150,1773404013,33599650,474543921088
20160530,469474286135,12118100614,433400007,1788434447,50249356,471262720582
20160527,470933246425,12946566059,408347779,1693078510,15409047,472626324935
20160526,472502816382,14550761697,449693374,1847415057,38126177,474350231439
20160525,473248745984,13439435439,447111489,1819093057,33450208,475067839041
20160524,474113760053,14061116207,435897186,1798419073,34425332,475912179126
20160523,473790185446,15087136624,422091594,1753543484,31403739,475543728930
20160520,473967145973,14282633644,416942266,1729756848,36595663,475696902821
20160519,474796983383,14160647518,422386820,1744718654,14410300,476541702037
20160518,474780510464,14732885027,465470861,1881965580,35905915,476662476044
20160517,478828511618,15685066169,467485550,1881070331,23463162,480709581949
20160516,479976560380,13682998225,459251370,1865306755,14189483,481841867135
20160513,479835870205,12799334852,465843265,1867654477,15437677,481703524682
20160512,482195898002,14746480437,487960984,1985512603,33452758,484181410605
20160511,484223329354,14605560018,476347184,1908372766,26286230,486131702120
20160510,486770066004,11967954223,465327237,1848438009,31123109,488618504013
20160509,489787952075,18589026402,454084772,1814654742,33873364,491602606817
20160506,493019015948,25206015858,448117885,1821751220,35486769,494840767168
20160505,498647195271,18795254421,443338759,1866740178,19508495,500513935449
20160504,498378241538,21673655978,459179739,1908585250,25394240,500286826788
20160503,498068800143,24446886546,459347061,1916449042,18254554,499985249185
20160429,494455780517,12930112151,465309165,1889693904,14545540,496345474421
20160428,498679671165,16736075918,483917118,1971968247,28580969,500651639412
20160427,499245448785,15286475183,478036407,1959244221,38562964,501204693006
20160426,500229477522,14289114810,452548563,1912955038,26178572,502142432560
20160425,501105836656,14531444301,452977787,1888084518,28658390,502993921174
20160422,501699887412,15483224766,434986489,1837147974,12498910,503537035386
20160421,504729309486,23671067589,455710066,1927995631,25810818,506657305117
20160420,506019596565,33417664759,459026202,1969683025,48540371,507989279590
20160419,512299527727,20853636754,445711924,1895798761,27911578,514195326488
20160418,512273796689,23645109654,437920187,1884974375,34238477,514158771064
20160415,513959169343,25338240194,424461774,1866486619,18578694,515825655962
20160414,515461028742,28430104632,423652179,1863849047,21268263,517324877789
20160413,514174217320,42312313729,427622877,1858861764,28609114,516033079084
20160412,510211622132,22416237700,442288992,1879843609,20861007,512091465741
20160411,512127578457,30698107375,437973551,1870649303,14677265,513998227760
20160408,509745451220,22781696856,439807776,1843290164,35715099,511588741384
20160407,512796499453,28556687517,430255162,1831830901,22893346,514628330354
20160406,513684986113,31676123292,425300564,1833000949,18494058,515517987062
20160405,512243331494,37092235507,418589155,1822755249,21010858,514066086743
20160401,506119519804,24633167935,425548227,1831175662,28752399,507950695466
20160331,510077307223,31153041676,413712825,1794732449,25351060,511872039672
20160330,509691637569,27927803064,405685748,1774343291,35280473,511465980860
20160329,508525327296,21930279771,396181058,1719011642,47876219,510244338938
20160328,509242174833,27189283089,372864875,1684440686,36392082,510926615519
20160325,508638683094,22318847529,353769333,1635002895,40192809,510273685989
20160324,509172156706,31986208234,352121756,1645545414,31359522,510817702120
20160323,509741838074,31494180992,337341767,1636604122,23831931,511378442196
20160322,507364047862,37857788437,326074971,1604722826,15475715,508968770688
20160321,505682813378,50440582760,344925865,1710875104,33931700,507393688482
20160318,494872388714,39428741515,368296267,1711273806,30866936,496583662520
20160317,488497078304,26128781409,374694739,1724225667,12120751,490221303971
20160316,483482073240,14991423218,438763762,1891260265,31708062,485373333505
20160315,490445133204,16199416635,426634136,1861084281,37963414,492306217485
20160314,493687362449,23766199588,411291055,1810427012,19494774,495497789461
20160311,489799692896,12450405720,420066293,1805079703,16191312,491604772599
20160310,492042339533,14785943211,428684047,1836636431,11993988,493878975964
20160309,492829696125,17033964898,430283330,1893220284,26064592,494722916409
20160308,495750615429,23630997269,414150365,1834114044,19682643,497584729473
20160307,497412906564,24748130963,417247123,1835425882,17338244,499248332446
20160304,494927660917,27790003531,428495044,1855487471,38390367,496783148388
20160303,503092878470,31372321447,418744722,1811602760,27678909,504904481230
20160302,502350546037,29767561155,410569729,1779203410,37776502,504129749447
20160301,499909493421,18523989704,404307775,1688144824,23312246,501597638245
20160229,501041987179,16891230852,405231549,1622773378,23683654,502664760557
20160226,509938422697,18373537956,399871995,1639939436,25497960,511578362133
20160225,513548523851,28390233205,399914491,1632454971,27139662,515180978822
20160224,520489250248,26164786546,395478038,1730924643,16853216,522220174891
20160223,519105100581,23392174306,390237467,1689257065,15163588,520794357646
20160222,519250340741,27522280606,386373075,1692811572,25534802,520943152313
20160219,517832856204,18210153720,371916455,1595130626,10528154,519427986830
20160218,519382998740,25395778727,383913855,1646122131,14700841,521029120871
20160217,518778341837,24752742440,384911339,1657639909,39836772,520435981746
20160216,518215198164,23605306843,353115874,1545662014,29933324,519760860178
20160215,515256205943,14930797529,338742330,1420264176,33851000,516676470119
20160205,514093133618,11901318369,321846648,1357030571,15155083,515450164189
20160204,524337017843,18541568615,338921731,1482084171,17319810,525819102014
20160203,526428042632,14409477762,344837635,1491080478,12578548,527919123110
20160202,528845887864,17563888365,349593177,1511792608,17212053,530357680472
20160201,528384301655,14080422778,353673284,1485180379,17458549,529869482034
20160129,533033638244,18426533048,357231158,1535234350,22432638,534568872594
20160128,537399576006,14896970875,370276921,1540722949,27725726,538940298955
20160127,546309759767,19749649503,371387521,1610207999,21792114,547919967766
20160126,558948682056,19547611732,386461946,1587722289,26214474,560536404345
20160125,573053955612,16889289523,377897322,1696416297,16201169,574750371909
20160122,574703509699,17864511418,377134445,1667792073,16171099,576371301772
20160121,577982711229,22361174852,399730250,1757858947,38134401,579740570176
20160120,581973101059,25779016479,389257526,1710066593,42551370,583683167652
20160119,583401330073,25220485677,388529453,1761695979,39923341,585163026052
20160118,584010365373,19081125394,368936025,1642374141,23324293,585652739514
20160115,585478803003,20242663855,360131694,1613659931,28249261,587092462934
20160114,594163365933,22803175759,352386407,1651483595,18888607,595814849528
20160113,600445497232,19525346812,367700213,1671474368,22850084,602116971600
20160112,610486743606,21769602015,361694462,1687383077,20604486,612174126683
20160111,622258836431,28150988168,378464622,1722772476,30254704,623981608907
20160108,640940954450,32514181166,366022477,1797468141,20464535,642738422591
20160107,653619923734,8743686393,389379514,1865346141,4980100,655485269875
20160106,659659894611,31039624222,397866642,2025469549,28591279,661685364160
20160105,662424991011,32738126135,386320746,1965327469,31410622,664390318480
20160104,674250015171,27746141351,378549763,1930428580,14767084,676180443751
20151231,680522261155,26481517358,389898016,2110497327,25617261,682632758482
20151230,690624418175,34774521611,387461740,2134120717,26235283,692758538892
20151229,689699599137,28878201901,384517703,2141562769,32745600,691841161906
20151228,690842371910,43463435651,379235236,2108756268,32431310,692951128178
20151225,702906554042,36861998896,375090359,2152587073,25677739,705059141115
20151224,704055938831,45768190084,379028086,2162580784,30225902,706218519615
20151223,701576990450,66173764807,401880906,2305921763,51599272,703882912213
20151222,694584343597,52008901722,379497194,2216629408,27847268,696800973005
20151221,690204973913,57466371747,387937372,2273711965,42034047,692478685878
20151218,685013347232,47396383227,370577565,2166047057,27117647,687179394289
20151217,685514996801,48712938670,377411347,2197465782,46942828,687712462583
20151216,687294173008,34465314026,364969521,2042483132,32766707,689336656140
20151215,686903667749,37186068080,358313963,2022022178,24072759,688925689927
20151214,686734828731,41328859936,370443012,2105881193,36024800,688840709924
20151211,679172485848,28365988971,392705280,2101063966,39897286,681273549814
20151210,680181466516,33681721847,393550719,2141678490,28977892,682323145006
20151209,681876332446,31912185019,390034517,2123493880,23454107,683999826326
20151208,683538869003,34153742415,393814894,2148104647,32121694,685686973650
20151207,688643130171,34763101101,385234259,2149554072,25501351,690792684243
20151204,689229679014,36130370822,377744415,2100381786,27582238,691330060800
20151203,701215140017,45460715372,376325461,2150847061,30091638,703365987078
20151202,705719889489,50746609725,378148759,2186265522,33975876,707906155011
20151201,707573181220,41187948449,373033872,2077790582,30813241,709650971802
20151130,705712846824,47647190662,371883683,2023533716,33414645,707736380540
20151127,707571655449,56361735197,376670438,2061163221,37988666,709632818670
20151126,721562735545,57063284399,372526076,2215328433,24195577,723778063978
20151125,722871325612,50585918649,372479695,2175357594,20468421,725046683206
20151124,724356454195,41952155661,375998490,2168170720,18347650,726524624915
20151123,724944067772,56462012238,374923464,2170416716,20020203,727114484488
20151120,727483864902,67868870592,377815849,2178878860,22640171,729662743762
20151119,723677944809,53377151926,372174144,2155202427,14272579,725833147236
20151118,718128393345,61645301015,384979790,2182866762,26764655,720311260107
20151117,719146385419,90257897879,381601346,2208478503,23878676,721354863922
20151116,709765973662,59783115668,377786256,2178454674,25881903,711944428336
20151113,704017531196,76119157073,376682738,2161492893,28225311,706179024089
20151112,704264669504,79386000166,372418079,2136717070,20899004,706401386574
20151111,698588480945,81460138173,367078322,2105019973,13686632,700693500918
20151110,692849446365,103276201336,371208287,2130119832,18309865,694979566197
20151109,678846032704,114272067940,372673657,2153097052,29373118,680999129756
20151106,657355073852,96065908261,361556937,2093561252,21716435,659448635104
20151105,648756449213,116126616192,359542968,2064814208,22044639,650821263421
20151104,636455607760,71377497141,363955809,2047299675,25119007,638502907435
20151103,624641794601,32485266484,365526279,1955303083,13980500,626597097684
20151102,624580223050,39182710955,371177740,1976302866,17635200,626556525916
20151030,626861304247,46046145880,362957410,1984153934,10749359,628845458181
20151029,628413061152,41575064417,368158409,2016767500,8236652,630429828652
20151028,625971542441,51781988858,380712918,2068703219,19354621,628040245660
20151027,628033239007,61805047765,369466382,2051580154,10231694,630084819161
20151026,625445402262,71288228506,367271524,2039335651,10104146,627484737913
20151023,618715633159,64264021721,367394423,2046744342,10908942,620762377501
20151022,614855939334,56765942023,370468855,2034048338,14514477,616889987672
20151021,609597972675,75043684698,377978484,2036721856,21703255,611634694531
20151020,614565648086,57331561590,376760079,2093241125,15975774,616658889211
20151019,608423367347,66704231174,371370016,2061897151,17272456,610485264498
20151016,602483217134,67307333866,364342531,2040780928,14634022,604523998062
20151015,600862476185,55174519045,383678231,2088067241,18192543,602950543426
20151014,595465800492,47314578853,388244607,2049097950,17526826,597514898442
20151013,592359492869,46417951657,384657890,2051103491,12068699,594410596360
20151012,590826463139,66079680740,385880309,2062409620,16875892,592888872759
20151009,573834927910,34773511196,392219396,2021609337,14676064,575856537247
20151008,573423934505,38105508897,390126838,2010065774,12684959,575434000279
20150930,565107689421,16667737149,383111420,1870766950,6144567,566978456371
20150929,573430370272,19494241880,395762758,1945833567,12445887,575376203839
20150928,578137194581,20771544015,402863318,2037096084,12470521,580174290665
20150925,579163991185,28658919129,396562589,2003971580,9271541,581167962765
20150924,588059276593,29077086812,396396967,2052014070,9860961,590111290663
20150923,588155766896,31571539567,393064710,2021242749,8809288,590177009645
20150922,590105583869,39312342594,396046839,2082180629,9943300,592187764498
20150921,589611425721,32786118443,395252238,2059120123,9537520,591670545844
20150918,588929671900,27492470550,397227742,2025406214,8837480,590955078114
20150917,590467294488,45357176136,400378022,2013711808,15327924,592481006296
20150916,588177192339,36654734196,403119490,2076672895,15983035,590253865234
20150915,587114144804,26800136447,416115086,2037093535,15951066,589151238339
20150914,599879253495,38443650467,420568640,2148978177,26778906,602028231672
20150911,618850315756,32940214326,410790112,2152125434,13731927,621002441190
20150910,619885682685,35958226095,421792143,2279414099,24070525,622165096784
20150909,622302002741,56720402464,417691860,2290625741,22264550,624592628482
20150908,613326503591,32848347074,424435597,2294014252,25730004,615620517843
20150907,615872695111,42713833063,421182250,2180453879,18633460,618053148990
20150902,606266170176,31013732169,417710441,2217686789,18465787,608483856965
20150901,642834471301,37495050672,418349037,2242361038,23722684,645076832339
20150831,673127713583,49354997209,438264408,2312390948,46944193,675440104531
20150828,683118490904,59881095450,410690598,2206833724,27151623,685325324628
20150827,685022556433,45681104014,444885202,2124421074,68989700,687146977507
20150826,706522058254,49181259228,405021453,1942973253,39309111,708465031507
20150825,740536035623,38055426386,397121654,1871872598,57083825,742407908221
20150824,795943105071,38245805551,391807060,2004816456,60377862,797947921527
20150821,848630862572,51673986450,381279185,2195223661,44073116,850826086233
20150820,869228227066,67585656067,399200479,2358282923,42621897,871586509989
20150819,875442817227,81247402297,405080751,2367304973,60862980,877810122200
20150818,879899884284,99199001573,424822078,2533802842,66503798,882433687126
20150817,894506794785,93341898906,405085221,2483435259,55929141,896990230044
20150814,886085989804,94821464981,378537615,2238103960,32101979,888324093764
20150813,882774372393,86857774356,430766284,2351486477,30547700,885125858870
20150812,873794479627,84189224771,437869763,2402549957,33045600,876197029584
20150811,870103319713,104695193380,416370751,2286113685,16105307,872389433398
20150810,861223721255,98653015518,420358094,2386249912,35050560,863609971167
20150807,845629259242,63254755083,396348385,2148973829,5112403,847778233071
20150806,839838718760,46010651060,466095533,2453501723,9671800,842292220483
20150805,842301741836,63096752525,472649945,2511051535,8743388,844812793371
20150804,842108030431,60977446773,477989807,2611179954,20185344,844719210385
20150803,832475432082,41851431424,481095430,2491448013,344467544,834966880095
20150731,859970601967,50034690518,431901758,2232410006,490047392,862203011973
20150730,881652186879,82706905549,431124222,2241704283,697464218,883893891162
20150729,881733008327,71228735424,399846272,2204435202,768767663,883937443529
20150728,887462793572,69518139535,372369603,2041011444,668174860,889503805016
20150727,919373759165,91115117073,402985425,2140343412,805299888,921514102577
20150724,940822832963,121558351199,396426559,2342381838,802224078,943165214801
20150723,941369680547,109984949964,370551723,2262926970,597044652,943632607517
20150722,928881478891,94378343848,385666185,2361120493,517651117,931242599384
20150721,928615710814,95165466241,378307958,2335036599,431586479,930950747413
20150720,921348386943,94950968728,355248393,2193555412,430413418,923541942355
20150717,921338704319,88919851672,283823973,1822969650,289434379,923161673969
20150716,918396130560,75364896359,288475352,1774737334,295156145,920170867894
20150715,920524732197,87450742190,293027310,1834758822,307415748,922359491019
20150714,936754623345,112517508100,286888194,1835725241,156604000,938590348586
20150713,934271207261,108699727868,272290354,1857208347,142599558,936128415608
20150710,932305971025,99007475226,253333446,1763754984,136284948,934069726009
20150709,927849404820,85033177459,264901325,1692753289,129269092,929542158109
20150708,940870474994,40122005740,263508669,1621043791,126455954,942491518785
20150707,1053097367290,65565705505,272716395,1858251281,209434967,1054955618571
20150706,1151409843974,86253165993,272593963,1913867669,280953116,1153323711643
20150703,1244976682669,75761353558,291951070,1946060586,1195700702,1246922743255
20150702,1293827661966,88487618099,361945765,2509128299,2453422624,1296336790265
20150701,1328818572775,102412410526,446136047,3032047503,2191541832,1331850620278
20150630,1335503814173,111609532061,399448299,2962511878,2611587657,1338466326051
20150629,1360422100831,111777711829,447069571,2869439317,2590020801,1363291540148
20150626,1387049624743,97236522159,420715654,3047418280,2085715999,1390097043023
20150625,1423248786555,112543339631,526175532,4077042981,1904698270,1427325829536
20150624,1439971876069,99110730843,467537982,3870183220,1833444664,1443842059289
20150623,1468845650070,71923409449,394954446,3262509775,1354114297,1472108159845
20150619,1479299517720,93916444426,381455997,3056543634,1576419073,1482356061354
20150618,1482910960306,102883459843,490123431,4003390202,1732961716,1486914350508
20150617,1475103559271,108881795164,528983150,4411760221,2174586687,1479515319492
20150616,1463951216264,110467806485,651077472,5010413917,1376855849,1468961630181
20150615,1460771548784,139727644688,714394315,5678984181,1683932637,1466450532965
20150612,1453579989204,140782088205,734805206,6017861873,1829689029,1459597851077
20150611,1443868735753,132745195582,735640495,6044144042,1564930174,1449912879795
20150610,1436953511811,132102202755,682946816,5922838027,1776050760,1442876349838
20150609,1428637577543,147185167674,692502719,5856847970,1866304046,1434494425513
20150608,1419155431830,175635531492,706327864,6066372273,2153296135,1425221804103
20150605,1412610800411,162459513338,626982856,5196658863,1397258933,1417807459274
20150604,1412300874405,140960563937,594151113,4894445720,2091611178,1417195320125
20150603,1402927079454,119037456520,593948327,4894947220,1550105851,1407822026674
20150602,1387882217728,133758105973,608826462,5040510626,1787608851,1392922728354
20150601,1367127995718,117887770661,627008827,5237617260,1888828181,1372365612978
20150529,1348287000435,109545698973,591895544,4975685928,1535238736,1353262686363
20150528,1345459596439,161711190822,653062958,5430216405,1479510294,1350889812844
20150527,1336990097550,126358447704,751439850,6425385136,1230064283,1343415482686
20150526,1329561906147,159094373511,769896709,6488280901,1505908324,1336050187048
20150525,1318998299726,164145678044,745828808,6190475546,1748595767,1325188775272
20150522,1314567656582,142752614727,665671261,5329555085,1773361484,1319897211667
20150521,1321176723760,108553228977,634903922,4925644941,1303497207,1326102368701
20150520,1310006880147,117098266840,601080316,4656256937,1687963151,1314663137084
20150519,1294245193796,113575243435,614797160,4763472053,2008707627,1299008665849
20150518,1278951775452,95383811648,619939863,4622251110,1578107544,1283574026562
20150515,1270378616254,103539242662,622531450,4746218114,1692384011,1275124834368
20150514,1271467867961,105312775966,727304965,5402256675,1732086628,1276870124636
20150513,1265406189486,132209749584,744973638,5472339769,1836400568,1270878529255
20150512,1256607720425,136448970581,707971746,5319748801,2148465499,1261927469226
20150511,1247505935416,119726264827,628804192,4834763087,2141547740,1252340698503
20150508,1245786699057,87812628024,536002927,4135054341,1669321134,1249921753398
20150507,1265872162917,94358842320,528167454,4030097633,1586470622,1269902260550
20150506,1258820234374,122153633570,647179937,4701559723,1579163978,1263521794097
20150505,1244231572418,128460864619,692133030,4992896354,1724892827,1249224468772
20150504,1241303319482,116900666542,821124336,5999922775,1694089441,1247303242257
20150430,1224334129835,135754031359,783508407,5831675719,1749354418,1230165805554
20150429,1221406603476,126739953108,794875454,6021609553,1887770640,1227428213029
20150428,1215607398598,148772163843,818516118,6149727519,2090163995,1221757126117
20150427,1210543730393,162760454052,829882223,6254062725,1970873725,1216797793118
20150424,1192302971884,153156908610,793270872,5965256427,1641802815,1198268228311
20150423,1185643651435,171737823864,839707386,6278465187,2013411225,1191922116622
20150422,1172665362874,165509139277,841589251,6368406198,2106225741,1179033769072
20150421,1153574815097,143192898510,800532646,5961506282,1946106430,1159536321379
20150420,1143069525623,165794251895,806776144,5886540287,1954779241,1148956065910
20150417,1149157713135,129211438621,819750253,6041055352,1380227173,1155198768487
20150416,1157182044282,112006268973,820992013,5973347250,2203963301,1163155391532
20150415,1146127306376,127637503244,815236850,5760511452,2243634120,1151887817828
20150414,1132444514795,135681414792,808065982,5734278801,2105259947,1138178793596
20150413,1112644681454,125462079457,837423227,6012263982,1717712021,1118656945436
20150410,1093646777627,120171575492,851628036,6013790547,1903813388,1099660568174
20150409,1080032082669,151266260607,950252465,7459280657,1839296323,1087491363326
20150408,1063907515309,146795417745,883306430,6090844298,1811107279,1069998359607
20150407,1049019510305,135205459177,890246879,6052607373,1812376621,1055072117678
20150403,1028339497560,121745692024,833666811,5639393066,1685019881,1033978890626
20150402,1019832320645,122445942102,845035143,5605667753,1548304018,1025437988398
20150401,1007500876332,112637594862,839075487,5579432794,1729479501,1013080309126
20150331,992114591127,116775077460,815494453,5408130188,1326090630,997522721315
20150330,987305162447,128248977117,840090452,5489035498,2127987302,992794197945
20150327,974695451811,94331337806,742424285,4882309085,1661692649,979577760896
20150326,971529344684,117308029200,717948665,4759646631,1763608907,976288991315
20150325,960086790787,115371500560,698297120,4643215819,1524507026,964730006606
20150324,948928112150,145585328346,689082182,4619080288,1829457216,953547192438
20150323,935961490802,122350894415,732427324,4789023959,1690085064,940750514761
20150320,927002173004,133491591365,657654705,4317418963,1858440114,931319591967
20150319,911756727783,119422295098,614805850,4136003055,1602861352,915892730838
20150318,896108504027,123253353097,627925841,4223177943,2044008241,900331681970
20150317,881882625541,118453665965,556521021,3731158044,1950507069,885613783585
20150316,874850559115,93488482835,529826432,3535076305,1466225810,878385635420
20150313,880611781488,76456008406,492300090,3193989076,1428684781,883805770564
20150312,878075844620,85412099181,495994833,3182040688,1862531473,881257885308
20150311,864004113742,65924942057,458202242,2927592012,1480830901,866931705754
20150310,848537789505,68915727800,505009170,3099078967,1633891332,851636868472
20150309,834878753182,70291104924,520205890,3353984453,1878488806,838232737635
20150306,824379989028,61530416037,529268837,3441280015,1400398864,827821269043
20150305,819402239652,70255155893,558295958,3596427868,1277060227,822998667520
20150304,811253368861,66225246334,590422635,3800138283,1108455680,815053507144
20150303,804100125942,87283032063,561490657,3658347664,1188200050,807758473606
20150302,792791389697,79111411070,600182396,3820324241,1086852330,796611713938
20150227,780843947820,67295472698,578066058,3643957926,906278384,784487905746
20150226,778901920692,70218750802,600194304,3727497308,1245468190,782629418000
20150225,770968145360,60092819984,522163877,3277751249,819377339,774245896609
20150217,753461212526,49701309648,468094316,3034256889,674412666,756495469415
20150216,772980408663,53928574063,506514032,3238037227,860489122,776218445890
20150213,779162373527,52535663244,529972301,3311066082,962369402,782473439609
20150212,804093283315,49061175820,533390006,3307983650,982933954,807401266965
20150211,805111175134,49814292794,552555015,3376239249,1102904755,808487414383
20150210,797891845821,49940656430,547550167,3321741382,1402007917,801213587203
20150209,786747284226,51281340753,552250455,3292347071,1497271319,790039631297
20150206,779641865766,51350016719,564209002,3355007223,1289932980,782996872989
20150205,777970437249,70696075163,675814531,3951049404,1324122648,781921486653
20150204,774770652233,55998184225,694053449,4075255266,1199049654,778845907499
20150203,773741930732,52159764433,687277595,4125153312,1068524030,777867084044
20150202,774866786825,47632245458,638069320,3768751438,998229174,778635538263
20150130,773977698926,50312558223,690478134,4040912993,914321293,778018611919
20150129,777561647997,55046202356,736792799,4327857932,998013384,781889505929
20150128,775933490835,63920072891,773840993,4542722686,1190286348,780476213521
20150127,773837742011,75031235777,798720421,4699665607,1220933535,778537407618
20150126,771373532853,67111894515,823866912,4885928763,1159453953,776259461616
20150123,766038511313,82258662501,794384758,4700104444,1307260513,770738615757
20150122,761668956446,75064691111,816099513,4785141949,973298500,766454098395
20150121,754595954233,91163378655,817893900,4822496958,1722377359,759418451191
20150120,750762421151,76513181618,719397938,4089037320,1507143437,754851458471
20150119,752047988453,72756876383,695039440,4006316935,1100466344,756054305388
20150116,766660200847,83138464387,836900593,5019945559,1212010371,771680146406
20150115,762382827637,71147906275,837376405,5061962503,1305319686,767444790140
20150114,749750725573,55908600370,819901731,4832460055,1031836955,754583185628
20150113,740893116001,52882711315,853669905,4970840174,1100244336,745863956175
20150112,735878164519,68855556662,871073168,5080926118,1075613449,740959090637
20150109,726400724109,87327038290,918874498,5383417787,1538413338,731784141896
20150108,718485280095,72365046460,943391394,5627589892,982279484,724112869987
20150107,715729306750,81243060299,999317750,6161617855,1159975687,721890924605
20150106,707391292198,98370829909,972732503,5990342373,1251407226,713381634571
20150105,700007355731,102462217665,998243783,6127222126,1448182019,706134577857
20141231,690304859709,80629221496,1033591309,6213794573,1501441714,696518654282
20141230,691781993774,76341827158,956068448,5620343498,1410191883,697402337272
20141229,687678463441,102445925919,921606454,5485660125,1498505294,693164123566
20141226,678646298701,87566428865,908219276,5392786771,1569099080,684039085472
20141225,672974233665,66548637889,884652636,5075978446,1692348394,678050212111
20141224,667220851499,60785434137,783877016,4423264212,1386061393,671644115711
20141223,669005263570,68088717135,847853767,4905506876,1286459935,673910770446
20141222,670595742509,96086844112,890122025,5146324106,1413056150,675742066615
20141219,667260348402,87986460410,859906608,4990159015,1622112746,672250507417
20141218,657356997782,86108084304,872698179,5116335254,1566415717,662473333036
20141217,648449628389,105662386619,865219858,5036994474,1821400330,653486622863
20141216,637958256722,92376303515,853613379,4957962271,1765606520,642916218993
20141215,628731166297,76617552763,814475178,4669814929,1349573360,633400981226
20141212,619376064853,73760055817,815521523,4628969709,1325624254,624005034562
20141211,617381768756,81319089922,854689464,4817034195,1443866814,622198802951
20141210,614042935191,92619534535,841858350,4845585561,1616220166,618888520752
20141209,605492638583,121843297582,914927637,5039482033,1591762695,610532120616
20141208,595995563719,114513688894,995831230,5686867709,1709393286,601682431428
20141205,575483801438,113474295457,892615083,5035049577,1540867053,580518851015
20141204,569429142951,105227574155,941956620,5252685856,1573490018,574681828807
20141203,552052549201,99700572568,903194391,4791756429,1448412944,556844305630
20141202,545712569004,76886420448,923073399,4828937503,1541232526,550541506507
20141201,538392930415,77440824794,921040710,4568075249,1378086937,542961005664
20141128,528992449890,77397865373,889100209,4426133104,1491509405,533418582994
20141127,522913808670,67309594520,805062141,4099983450,1303976656,527013792120
20141126,518602496677,67013032917,755040399,3830675045,1220782039,522433171722
20141125,509781678532,59098287139,700758902,3601461778,1196315299,513383140310
20141124,499260287798,69936096428,662448084,3450542062,1453456183,502710829860
20141121,485787498700,37965320439,669336273,3334098780,1042151760,489121597480
20141120,483384872787,26772643084,695967139,3367936291,868061627,486752809078
20141119,481691069603,29457074491,665399210,3264178092,892735104,484955247695
20141118,479387054532,30864025290,671129141,3318621527,841441801,482705676059
20141117,476797912474,33657280576,758355649,3685735609,796147149,480483648083
20141114,474451979124,33685785420,809489891,3805366969,859203537,478257346093
20141113,474102238964,47038257972,845053146,3918633272,1089309031,478020872236
20141112,471792706194,38069159328,832982089,3882134761,1093428955,475674840955
20141111,468511764722,59512181726,800379944,3677941190,1203971043,472189705912
20141110,464090522420,43074937834,827763105,3775253288,1208677572,467865775708
20141107,460794750926,43096954614,653784032,3151991170,1139240456,463946742096
20141106,460287164514,31786397981,622440545,3071093972,883170931,463358258486
20141105,456679655698,35525776693,650164593,3175028313,935088084,459854684011
20141104,453445058673,39878215488,647859142,3196509968,955937193,456641568641
20141103,449802419175,41008787115,648973897,3221660705,992203255,453024079880
20141031,444331032561,42922083624,644906244,3139694050,1093918443,447470726611
20141030,443442891214,39726432779,571062165,2863055358,1049889692,446305946572
20141029,439652493432,37671197598,479029360,2611824795,943217116,442264318227
20141028,440302363994,27452149524,404811012,2314768155,893030334,442617132149
20141027,441744151692,20724534608,332511522,1996485943,799180180,443740637635
20141024,439035804092,20161466320,372718592,2199412318,720012033,441235216410
20141023,436985726360,25192335627,408886028,2340514878,817182870,439326241238
20141022,432871031115,24355603992,494400773,2693781267,822328450,435564812382
20141021,430306864259,24884170638,536925943,2802116786,713476074,433108981045
20141020,427824766563,23487001573,537157389,2824265997,748585888,430649032560
20141017,425311288395,29063327336,487718729,2654957393,743205694,427966245788
20141016,424530873677,35283134771,585040803,3010510230,931306322,427541383907
20141015,422266917101,31845671858,552337971,2885487467,774764311,425152404568
20141014,417913475124,30016767013,534018157,2752285172,783993509,420665760296
20141013,413817989559,31602674452,519860635,2684864566,749586286,416502854125
20141010,407459730065,34135897574,536135153,2772753535,768465628,410232483600
20141009,403598187437,36582698297,547404751,2858754154,811258045,406456941591
20141008,397396842118,37442090357,559818258,2836409256,923699622,400233251374
20140930,386227534354,27147344071,447007098,2402153637,672778691,388629687991
20140929,393042488212,28613142315,507492826,2644410326,757653472,395686898538
20140926,395131055448,27354261183,519168328,2654825242,850494322,397785880690
20140925,393151191091,35791324236,488477394,2618340050,904722652,395769531141
20140924,388077718595,35224990253,516421911,2717092663,1100530763,390794811258
20140923,380499940014,22613124910,476327632,2580377167,851878416,383080317181
20140922,377641662610,26802465503,444658130,2472695378,611299373,380114357988
20140919,371414736256,23437077528,505039270,2743342013,779322832,374158078269
20140918,371022528916,23454655704,515412100,2754050358,910651338,373776579274
20140917,368035491871,24747959534,481116386,2633272090,759755012,370668763961
20140916,364561939383,38576347008,494045733,2675808937,882829505,367237748320
20140915,360155185805,30277233230,493654518,2786068344,741223637,362941254149
20140912,354592937514,25877300283,524061365,2854744948,677360994,357447682462
20140911,351356901278,31551508007,508336149,2809839184,813463327,354166740462
20140910,347084945437,26516564784,524305237,2844850067,689374080,349929795504
20140909,342444319645,29429506399,604878031,3157574813,674256665,345601894458
20140905,337114774267,27435309267,607844092,3167707067,718005670,340282481334
20140904,337616642418,27868392314,557972740,2987580074,631924778,340604222492
20140903,334451881572,28142266923,510673136,2802271135,754505396,337254152707
20140902,334304257645,25074482942,459853238,2575067297,748140249,336879324942
20140901,334993392377,19375199451,420833944,2353464222,526996495,337346856599
20140829,333028014188,14869789058,427854960,2336768882,584884633,335364783070
20140828,331974283614,18075448159,416710514,2306178645,647097944,334280462259
20140827,327033468171,15775159716,466948496,2506072682,621260285,329539540853
20140826,324639044384,19645912134,477910818,2545234947,514061085,327184279331
20140825,322692875254,20660713907,525815421,2712634191,621002441,325405509445
20140822,320712615102,20931605475,539562024,2777758609,558178032,323490373711
20140821,319781417111,20937372387,522418447,2783449809,520977083,322564866920
20140820,316919893355,21102254552,559844185,2952936920,585841603,319872830275
20140819,314000082686,24478938058,558964767,2971229057,651976796,316971311743
20140818,311144915581,22116914462,545878941,2928628202,523299838,314073543783
20140815,308505667412,19882847811,549070930,2926728670,648326303,311432396082
20140814,307293179271,21440618954,537777146,2848463783,524203849,310141643054
20140813,304160550816,22784891797,549787632,2941328293,552469178,307101879109
20140812,300455598098,20662634626,566152801,2993821657,519066175,303449419755
20140811,297415010530,19756935325,595874736,3098591058,628749710,300513601588
20140808,295837518089,16839331892,511141987,2739068954,457482616,298576587043
20140807,294718230086,21831148630,553475703,2880806829,503910514,297599036915
20140806,291615855527,22133809226,718356226,3394814354,600292309,295010669881
20140805,288090413294,21974257920,646019448,3367752810,535884671,291458166104
20140804,285698012007,21361247609,669994503,3494808384,622623693,289192820391
20140801,282807951055,20877644942,604541045,3183147027,499792345,285991098082
20140731,283472878022,19428333365,637597008,3299144167,562002156,286772022189
20140730,281191829508,21820828528,621204665,3224125568,526037245,284415955076
20140729,277436563438,22313772448,643909616,3273443034,570960875,280710006472
20140728,275792314276,25330816505,602367464,3096334488,837980913,278888648764
20140725,276338715895,16146244265,485628190,2609137766,653919936,278947853661
20140724,277337816759,19341209261,480781456,2523214638,781324478,279861031397
20140723,275745037661,15381414613,408977710,2215194858,608947146,277960232519
20140722,273882387833,14498460951,420753681,2198534959,673156369,276080922792
20140721,272800679038,10107133251,395796666,2153674887,414377242,274954353925
20140718,273067071370,10487979224,363760230,2050709730,449770806,275117781100
20140717,274021765613,10449050940,348209476,2020042857,364431807,276041808470
20140716,273677477762,13832170116,368431573,2024579463,550544268,275702057225
20140715,272382809571,13649257521,335855032,1887331655,449671396,274270141226
20140714,271692944012,14022448475,320726698,1819218966,491241717,273512162978
20140711,270336177205,11432852766,304315056,1743881323,387263768,272080058528
20140710,270150328048,11445433593,312335779,1789239958,438918350,271939568006
20140709,268976908835,13708146360,321895785,1837924169,442627206,270814833004
20140708,267771059963,11443120248,356328337,1941623111,431865953,269712683074
20140707,266651924011,11498589639,360983132,1964318103,459386341,268616242114
20140704,265436852269,11209332181,351429329,1909107890,457240169,267345960159
20140703,265974898727,13478521704,354317677,1920076729,596042331,267894975456
20140702,265240147977,12502321252,321647158,1804553417,511541725,267044701394
20140701,264607937184,11619124167,299236702,1728225591,328687972,266336162775
20140630,263735543924,11863350290,366129787,1864005213,571830221,265599549137
20140627,262843748934,10674745540,301262117,1670352288,567235752,264514101222
20140626,263901777459,8934494319,291804496,1705964326,427774674,265607741785
20140625,264826122031,7798911904,284059871,1729313567,386524893,266555435598
20140624,264557736440,8678669140,298013493,1783361767,444842281,266341098207
20140623,264423995477,7984521565,268562075,1711404991,509041591,266135400468
20140620,264462000733,7311573935,256773555,1659092486,455954978,266121093219
20140619,264416711355,11575621771,272158884,1692954281,471621209,266109665636
20140618,263464984389,10981607193,327078543,1905445146,596836596,265370429535
20140617,261262566962,10678375115,347794481,1986059991,445866109,263248626953
20140616,259830180798,10960047052,383097959,2128107268,554372917,261958288066
20140613,259234464249,11035429772,330619081,1932557952,526948093,261167022201
20140612,260095159980,9619440443,313294537,1880328796,389478460,261975488776
20140611,259331157651,9242894688,313315711,1902826720,418877395,261233984371
20140610,258915454209,9738387204,330908321,1925383864,495122774,260840838073
20140609,258813086318,7991678955,295477968,1790513118,468188414,260603599436
20140606,258783819562,7841012896,262974892,1676569971,346320349,260460389533
20140605,258996504218,7718020196,294637183,1793129953,383802206,260789634171
20140604,259577930516,8028118877,271997131,1702384698,395633241,261280315214
20140603,259934197396,8771506084,291677668,1785620918,481673233,261719818314
20140530,260267422226,8167969061,270315721,1702233281,393229868,261969655507
20140529,261867723917,9774455584,288072807,1773432798,402510032,263641156715
20140528,262495558871,10723796154,312371350,1849684934,478352223,264345243805
20140527,262184505749,8449243396,294368537,1786177552,464635704,263970683301
20140526,261798286090,8649747489,289836117,1769480155,435522588,263567766245
20140523,262179721956,7232471152,289470665,1742951754,421775919,263922673710
20140522,263285667241,8451473422,293952400,1758195332,411065463,265043862573
20140521,263711250561,7437968535,290253832,1769018748,554334184,265480269309
20140520,263329869576,7378819909,264519437,1660684994,407006502,264990554570
20140519,262978461564,8257521627,256420841,1636149807,411757235,264614611371
20140516,262504748253,6777228354,254283436,1674467649,358331263,264179215902
20140515,263365496848,8055799282,261473338,1714345106,436143161,265079841954
20140514,263785295626,7703544903,302805472,1827570230,376333959,265612865856
20140513,263875665230,10210290975,300233901,1857824098,341660691,265733489328
20140512,263336148453,12716672910,316539590,1887908530,517233276,265224056983
20140509,262894808767,7334172832,263259050,1705756394,409249410,264600565161
20140508,263640476055,7985052061,294182863,1789704684,378944870,265430180739
20140507,263849484060,7547560079,291050868,1783931061,433098190,265633415121
20140506,263870108487,8424672721,291324162,1790872794,485860492,265660981281
20140505,263125449389,8516572164,279157134,1728998220,437716918,264854447609
20140430,262009980050,7247352226,248958249,1635791841,321016213,263645771891
20140429,263634326264,7772909913,264533302,1691287829,463996527,265325614093
20140428,264627794987,8967146941,257761033,1613005629,428957376,266240800616
20140425,265576759765,9783865720,290233116,1721207938,398306780,267297967703
20140424,266725968953,8580516470,348963789,1905803549,422788291,268631772502
20140423,267460402473,8985208087,325476173,1860871023,431177873,269321273496
20140422,266870388802,11267977775,305325870,1799916359,498582898,268670305161
20140421,266692676276,11210339116,301789768,1769176200,477960722,268461852476
20140418,266499969446,9577431792,287242016,1794892129,374983845,268294861575
20140417,266776778235,10134509283,330355879,1934603170,324658411,268711381405
20140416,266555259816,10267873861,330635368,1975243309,362009563,268530503125
20140415,266244836275,13534438812,314794767,1903452565,294872317,268148288840
20140414,264564175463,12074556314,367306449,2121974869,367334437,266686150332
20140411,262883689026,14611841647,384965781,2175945347,436033396,265059634373
20140410,262944130727,19699552948,395589445,2251706479,579654220,265195837206
20140409,260538989557,12507535371,340435478,2046832746,378482964,262585822303
20140408,259332941260,15064019071,379430465,2142303390,677734271,261475244650
20140404,258587521605,8204649460,323644312,1915929285,386841831,260503450890
20140403,259439552720,10708696243,338802278,1951085811,515881175,261390638531
20140402,258348609225,9776632960,357172759,2028112154,509755055,260376721379
20140401,258455252144,7454147839,329582717,1882870067,299476363,260338122211
20140331,258890954278,8313336207,315372340,1788598988,320555736,260679553266
20140328,259105897661,10963018786,322624543,1781791692,351554903,260887689353
20140327,260095867854,12509484624,341174945,1858453331,527446678,261954321185
20140326,259400663608,10473570962,365487641,1927608947,375383768,261328272555
20140325,258315904924,12745301869,359963463,1903062121,419892694,260218967045
20140324,257147141519,14887597993,358982196,1905006670,534188976,259052148189
20140321,255770666920,14222628366,306673488,1740051312,694067021,257510718232
20140320,255559503792,10997485798,390205441,1946992062,408416362,257506495854
20140319,255575562621,10216100311,449441334,2053149380,329802162,257628712001
20140318,254150400180,11016382497,488658181,2153234090,307781284,256303634270
20140317,253043587759,9484884772,492981307,2184786624,346139134,255228374383
20140314,252331071010,8951176202,488064245,2151721772,289536899,254482792782
20140313,252761075051,10331280705,483937455,2192453531,516236308,254953528582
20140312,251945854288,10131458341,422673168,1997247313,519314091,253943101601
20140311,252038649300,9244370725,388371182,1917867637,518475094,253956516937
20140310,252414971026,11738421987,362900252,1830208829,449345548,254245179855
20140307,253050872759,11198350419,304513619,1793411804,350246872,254844284563
20140306,253730966768,11798471888,276332011,1704549281,447122447,255435516049
20140305,253240132979,11196972813,299624044,1750662801,364577596,254990795780
20140304,252351780621,12125200646,291377717,1699560915,419070658,254051341536
20140303,251983073596,12657075837,279935937,1677166495,414288005,253660240091
20140228,250685575955,11898490852,249070155,1590875805,453430707,252276451760
20140227,250675886815,13592753313,269433840,1624211532,576954165,252300098347
20140226,250664112715,11539038673,221440769,1410092409,413732928,252074205124
20140225,249672061830,15187411554,215305068,1436846056,409132399,251108907886
20140224,250050968636,13189674622,216281062,1480014536,420273062,251530983172
20140221,249701725590,12045784878,237719811,1549862047,303760600,251251587637
20140220,249861080842,16705939916,270187624,1702618265,485700886,251563699107
20140219,248756501420,16467807361,263589732,1710771073,544344331,250467272493
20140218,246823602738,16987912093,215374452,1524191379,521044568,248347794117
20140217,244480638839,16297930378,234841562,1609881723,351927197,246090520562
20140214,242428321403,11422214895,228509451,1540651251,288082468,243968972654
20140213,242214544627,16575349032,254394920,1598740564,484546617,243813285191
20140212,239798698269,14427258810,238999956,1556251316,444801939,241354949585
20140211,237113578259,17047728070,252608067,1588789186,529137869,238702367445
20140210,233894222460,15675885762,225887393,1481220821,427008003,235375443281
20140207,230299148177,10055176584,172647885,1303402675,303879043,231602550852
20140130,227890201770,7046396520,152716226,1158623034,207762324,229048824804
20140129,230617999048,8042093293,185304033,1337871390,208615454,231955870438
20140128,231923649468,7893789417,187152618,1349330588,255296701,233272980056
20140127,232466131188,10823464032,183628045,1323031454,288632280,233789162642
20140124,231774564282,10368793788,190789333,1391626771,362572139,233166191053
20140123,231945821615,10130547148,220619872,1495065117,280726467,233440886732
20140122,231326049737,10873150808,264444360,1619788087,392040765,232945837824
20140121,230777571850,6968031351,217439214,1502450099,308110357,232280021949
20140120,230791913661,5607296766,212692229,1499170924,239283326,232291084585
20140117,230412377549,6844410935,216779452,1526453295,281672856,231938830844
20140116,230060965821,7656168912,239050510,1627160554,329057994,231688126375
20140115,229811843792,7343289231,234939151,1597822610,332330199,231409666402
20140114,229311743389,6685515130,241626323,1608590091,362113144,230920333480
20140113,229499201270,6346364908,229413614,1568228234,462661185,231067429504
20140110,229737294553,7004169454,231295830,1537336124,319225435,231274630677
20140109,230020088540,8847269593,238660143,1593767536,413420487,231613856076
20140108,229156113820,7463940724,242021069,1636238245,389624522,230792352065
20140107,228638358705,5910246628,235286454,1583705720,368645925,230222064425
20140106,228761343756,8036279087,215850289,1523790712,329112079,230285134468
20140103,228595221625,8292729532,214560754,1513927862,305042145,230109149487
20140102,228710320652,7318939312,224484301,1557077302,266695937,230267397954
20131231,227978800560,8322266045,281121010,1941704951,395736654,229920505511
20131230,227841453605,7661097572,223145036,1576943369,352047019,229418396974
20131227,226225117946,7154176521,235543329,1633137598,338202390,227858255544
20131226,226080169376,7599426050,219639719,1555870062,368615931,227636039438
20131225,225648698731,7189385295,222519884,1601746673,384986688,227250445404
20131224,224885880852,7147729797,235599691,1623243047,364602298,226509123899
20131223,224630867846,6322420368,253981537,2056358199,371608489,226687226045
20131220,224521974124,8431881585,237090064,1991697488,359249900,226513671612
20131219,223938461000,7640597803,283875618,2222825167,409196018,226161286167
20131218,223477645995,6566113157,300506152,2331707768,413646467,225809353763
20131217,223119201208,7944323087,295652201,2289216797,441217017,225408418005
20131216,222639526363,10065271956,293988236,2295022879,380482967,224934549242
20131213,222160998519,8306245916,301534200,2400704905,301663085,224561703424
20131212,221822316366,9104756903,310135655,2475665080,344642278,224297981446
20131211,221251487178,11396977221,299368754,2439830624,319960864,223691317802
20131210,220430882924,10904198792,362807454,2719960237,413847769,223150843161
20131209,219870191278,10295777349,359392520,2691086939,444643920,222561278217
20131206,219018926924,11386150208,345786178,2687886724,425520920,221706813648
20131205,218992823965,13270367701,387724054,2908320533,484020701,221901144498
20131204,217474470295,16912819278,412208484,2920550103,634296804,220395020398
20131203,215434592177,11588419026,412217007,2875096546,397853341,218309688723
20131202,214501095497,18825414865,409942747,2871419826,583814195,217372515323
20131129,214338911415,12276834363,350778504,2658498226,303102807,216997409641
20131128,213683293087,15322298770,406972873,2760348375,501833255,216443641462
20131127,212898156243,13499390746,418182873,2796133632,512622586,215694289875
20131126,211631484011,10115487484,420454976,2740380984,352605025,214371864995
20131125,210513952379,11502984333,437176325,2766978465,386004112,213280930844
20131122,209874858137,12613775426,439028276,2790740399,361300354,212665598536
20131121,210072572200,14047646788,456017443,2836659491,446905061,212909231691
20131120,209551620382,11941657028,476549154,2899116267,301975097,212450736649
20131119,208019451901,14291513606,494243074,2945513244,358409734,210964965145
20131118,206617132564,17385149820,534028529,3031303176,590106038,209648435740
20131115,204613488552,12875770762,416139904,2471550714,475180877,207085039266
20131114,204094642394,8086155715,413585407,2432882670,391075257,206527525064
20131113,203714786414,7971881104,389609409,2291868589,298198432,206006655003
20131112,204586680613,7050099028,413180144,2366914676,334986582,206953595289
20131111,205042273510,6425591468,373798185,2177365481,307234108,207219638991
20131108,205288449011,7553280095,344690470,2135590463,333473813,207424039474
20131107,205764221280,7550981079,389870040,2345686986,323705640,208109908266
20131106,205683423245,9209313933,386999073,2429767206,375285339,208113190451
20131105,205472045476,8215742533,399299586,2496007077,368508807,207968052553
20131104,205076226328,7331468487,396486629,2477597195,299001952,207553823523
20131101,204392050866,7333884215,387365408,2426487149,336480756,206818538015
20131031,205743564821,9119163699,384826016,2410668233,363523110,208154233054
20131030,205960182509,10483842273,391498211,2493786032,477256380,208453968541
20131029,205671288019,12384293585,351767184,2334651767,518587949,208005939786
20131028,207060004715,8194772139,344384698,2273933933,325363016,209333938648
20131025,206294779848,10652188072,340504377,2233689869,338160431,208528469717
20131024,206258104969,9279885380,365061476,2350893103,366287337,208608998072
20131023,205582514365,12942644847,366302833,2381959619,473153968,207964473984
20131022,205600238723,14930082234,368793983,2448248584,407944680,208048487307
20131021,204341953702,13903779523,371051278,2472862227,464469181,206814815929
20131018,202632187972,9052738286,363569973,2392196627,340294381,205024384599
20131017,203294640806,11697484959,346092176,2324039569,314307037,205618680375
20131016,202459072287,14308912267,333200336,2307926333,352876240,204766998620
20131015,202446094767,14754585887,366045786,2497712626,344150755,204943807393
20131014,200189301778,16401031686,367437599,2495987584,393230731,202685289362
20131011,197583295389,15382323544,359200108,2467334758,441604632,200050630147
20131010,195962993170,15182552559,339648905,2354044553,340165921,198317037723
20131009,193433461807,13769689813,357359138,2456450737,375571559,195889912544
20131008,190620546052,15019950957,366879711,2507698233,384258607,193128244285
20130930,187007772810,9374945480,316975815,2277092903,246562420,189284865713
20130927,189444140376,10876838276,331914844,2338569970,317802283,191782710346
20130926,189696837512,13657728519,358659121,2451235734,355831218,192148073246
20130925,188780192009,14754504704,409763163,2709037025,368654953,191489229034
20130924,187832693086,15891243985,417705709,2728328302,386715705,190561021388
20130923,186139026272,13746039404,444150091,2853246774,369637645,188992273046
20130918,183564952864,10866924948,411050650,2705430781,353696624,186270383645
20130917,184432606809,15108935690,448774820,2863619152,315685231,187296225961
20130916,182712428747,15316387321,522282478,3159050563,379393184,185871479310
20130913,180047463400,14794724049,540120825,3247774810,360354435,183295238210
20130912,178704168813,18661489213,597504616,3574484088,535453455,182278652901
20130911,175218296628,19066763751,578514557,3342404054,434966296,178560700682
20130910,173742910141,20039717034,569671648,3327962635,534984688,177070872776
20130909,170263953063,19419627776,572841053,3326596369,643061268,173590549432
20130906,166841574757,11281155028,458059741,2758154510,387077105,169599729267
20130905,165979329356,9804211049,452218205,2760954500,279374936,168740283856
20130904,164744972424,10667189067,461955387,2814405924,326141151,167559378348
20130903,163836243571,9264282240,455211449,2799921927,309326278,166636165498
20130902,164203170766,10893889831,441640321,2793804345,352991068,166996975111
20130830,162731361276,12066151492,441431963,2786331383,398632179,165517692659
20130829,163646162418,10194973629,449724419,2783127447,318545128,166429289865
20130828,162036114549,12670096372,459271193,2867436147,410235222,164903550696
20130827,159897225927,10505399464,455087313,2907627936,382970001,162804853863
20130826,158142844823,10303492304,461360635,2962018629,449671375,161104863452
20130823,157206691091,9468849165,434019283,2737223795,373467241,159943914886
20130822,157187498032,7154595112,451704878,2864261101,296577412,160051759133
20130821,156834706420,6940768662,456856009,2866554016,306865258,159701260436
20130820,155661493166,8705919775,473710694,2935192988,432898632,158596686154
20130819,154828299983,7878352329,458511012,2907723962,427495712,157736023945
20130816,154515208872,13006565961,468380174,2839761298,591046376,157354970170
20130815,153382068990,7899681215,483929193,3054873234,296980699,156436942224
20130814,152811481913,9089551977,511343014,3191811966,354927551,156003293879
20130813,152674633346,9467806071,516575565,3213818900,312581246,155888452246
20130812,151556419573,10517806898,534690876,3289803971,422254784,154846223544
20130809,151564666504,7775889605,532873753,3131592635,322595309,154696259139
20130808,151421916796,7147549342,551215343,3184371304,302562314,154606288100
20130807,150260238669,8933967401,562354436,3248447266,353901159,153508685935
20130806,149657184867,8542220553,560754251,3207775784,341131891,152864960651
20130805,149397053080,7193323164,562127595,3258698825,267773693,152655751905
20130802,148969271079,7328513424,571196826,3167904972,244524797,152137176051
20130801,149555722683,7121569170,669954254,3337528664,354785014,152893251347
20130731,149420127021,5473314564,688141829,3310731997,317514868,152730859018
20130730,149207743996,6003056011,668748160,3192347775,354839138,152400091771
20130729,149188477758,6003177022,660636545,3146310551,364563120,152334788309
20130726,148875607683,5432377690,584027672,3020509405,272334242,151896117088
20130725,149232789418,7665729318,579938408,3040026973,365801524,152272816391
20130724,149279195818,8617463762,554078145,2930065483,443661952,152209261301
20130723,148858609892,8486417073,528495519,3001644404,465502092,151860254296
20130722,148324934682,5694020549,516275709,2872246439,407632288,151197181121
20130719,147876128209,7248688103,502247173,2796392120,446867647,150672520329
20130718,148720424372,6705464503,502715126,2904179326,329896451,151624603698
20130717,147809024524,7738122870,554605991,3120392198,362363182,150929416722
20130716,147690127651,7899410046,603789521,3279213977,404277328,150969341628
20130715,146480487307,8714916690,545894285,3162192097,393604878,149642679404
20130712,145732591370,10184240097,543415311,3012711389,313147034,148745302759
20130711,144993447524,11836354163,724533627,3534498235,405142193,148527945759
20130710,145468426190,6516616406,788853066,3459103698,321720518,148927529888
20130709,145223927180,4060138518,776212943,3406756562,280443999,148630683742
20130708,145461882454,5161294561,765919918,3349007814,290271717,148810890268
20130705,146113979021,6311258009,746417774,3346427225,295951637,149460406246
20130704,146431475969,6940758376,705957074,3222892968,363351094,149654368937
20130703,146331396911,6458798024,666149816,3122156208,392375429,149453553119
20130702,145793434860,6140202318,604798583,2994913148,363271927,148788348008
20130701,145470354637,4848225334,554047588,2788908395,406632907,148259263032
20130628,145646592122,6216909816,473465671,2530272294,503128004,148176864416
20130627,146817016731,6272155736,407714571,2249592302,571116427,149066609033
20130626,148060353548,6758398626,324544187,1947125975,593516269,150007479523
20130625,147919911357,8118020855,284873562,1778591939,719022421,149698503296
20130624,150897063226,7735165100,241094775,1790650183,569964484,152687713409
20130621,152615187662,5782677649,239939372,1965173140,486182674,154580360802
20130620,152880634081,6490612227,267805604,1987313226,373385951,154867947307
20130619,152169383198,6713609038,332495342,2207794093,492808671,154377177291
20130618,151212539265,5884392397,301010932,2230422477,477439795,153442961742
20130617,150422821027,6939993912,266931758,2128562400,428371823,152551383427
20130614,148836812594,5797043147,265154999,2061640842,374802575,150898453436
20130613,149005277420,7009864137,236661204,1993164182,332491436,150998441602
20130607,148108787978,7526886429,215926657,1957883747,235243875,150066671725
20130606,149151822571,7577268832,233869034,2071556115,242293234,151223378686
20130605,148965564717,6605148405,249272537,2183048019,237057925,151148612736
20130604,148442795180,8363093077,259566015,2171821367,335833052,150614616547
20130603,147120806309,8694878633,345692219,2557650932,301121296,149678457241
20130531,145252249948,9369266328,283827772,2258880000,359663134,147511129948
20130530,144688843185,10070309550,307986096,2418228409,339229593,147107071594
20130529,143149532749,11029505099,318752046,2456234080,416142975,145605766829
20130528,141777400469,11214809176,327865545,2455374710,457461210,144232775179
20130527,140820346371,9894922165,302399486,2305293833,286551661,143125640204
20130524,138984769078,7928041003,288295711,2234197713,251500832,141218966791
20130523,138316858947,10511455801,310549981,2344207599,314530094,140661066546
20130522,136139858373,9552038138,324325489,2437489139,260782720,138577347512
20130521,134817899289,9591121306,314915983,2334850741,267288382,137152750030
20130520,133091760357,11095254875,346464716,2517281991,375552639,135609042348
20130517,131417103569,8768077046,356603362,2470385623,395353262,133887489192
20130516,131622975578,8878686659,355984760,2475366123,395813111,134098341701
20130515,130323971618,5529182884,337709979,2433053208,254134124,132757024826
20130514,129517780377,6593084766,311169908,2337690202,246497726,131855470579
20130513,128164330004,6459752621,311975510,2360915033,275974650,130525245037
20130510,126740444825,6034576415,302954623,2303727340,290496190,129044172165
20130509,126419196551,8168053782,328586084,2374710357,252690084,128793906908
20130508,124888103709,7157542145,361546449,2507217737,301418246,127395321446
20130507,124270338683,7074720877,329810628,2362140752,303058394,126632479435
20130506,123361128607,7268197122,308417317,2276921533,339490889,125638050140
20130503,121887004198,6620964102,273711623,2148735200,352356561,124035739398
20130502,122197863473,5644481042,256379935,2057674882,262890394,124255538355
20130426,121166321228,5086048547,231242790,1942209657,231262387,123108530885
20130425,122009589488,6886959934,281114391,2172998614,336901479,124182588102
20130424,121552670270,6827152161,301987832,2287185309,379207719,123839855579
20130423,120768319189,7082174321,276912714,2131780731,257901753,122900099920
20130422,119391719252,7099827303,321564829,2384691901,219729253,121776411153
20130419,117698737075,7739024920,352285862,2443084447,412698424,120141821522
20130418,117671674605,4771936720,329887400,2292643432,295537900,119964318037
20130417,117144800742,4875309857,327887516,2267620822,391843539,119412421564
20130416,116263244718,5209405509,296228182,2139946274,307886724,118403190992
20130415,116037778763,4245116922,310449750,2199324054,266042893,118237102817
20130412,115950047834,3905815812,303698649,2148492748,213041967,118098540582
20130411,116103113411,4192362486,316677057,2152973603,201267777,118256087014
20130410,115776352843,4753020947,312303383,2142951912,288025234,117919304755
20130409,115626276701,4952528226,281641041,1985863434,320378225,117612140135
20130408,115054289211,4894186965,231800180,1762793624,298927793,116817082835
20130403,113947874189,4074983283,238181467,1829121676,269389114,115776995865
20130402,114124843819,5298058935,233982688,1812584900,288122642,115937428719
20130401,113635641259,4542232360,236893360,1823593206,232219448,115459234465
20130329,112888053998,5204018492,235085790,1883391009,287753194,114771445007
20130328,113187084739,8010031524,241346363,1899979450,325060876,115087064189
20130327,112137310840,6298683390,291761330,2269197193,267285479,114406508033
20130326,111035476296,7099634360,294171941,2248488085,266674030,113283964381
20130325,109877567428,6297772712,316957896,2449059912,279004940,112326627340
20130322,108591092977,5511652970,318449443,2435871005,243690346,111026963982
20130321,108019003348,7062886655,334857043,2483731778,270158014,110502735126
20130320,107196193138,8066187351,331895869,2399762325,415504328,109595955463
20130319,106755434421,5201097686,291718070,2130073796,289261107,108885508217
20130318,106238513278,5282720607,276039932,2019528889,267797480,108258042167
20130315,105626987105,7471161896,288992367,2011775416,408902401,107638762521
20130314,104874569425,4609782978,286117015,1996905584,283442449,106871475009
20130313,104108557626,5513877779,254251612,1825837512,299097407,105934395138
20130312,102711768682,7022483678,262582542,1902714770,314762594,104614483452
20130311,102821772759,5082088791,267982074,1948452838,276632787,104770225597
20130308,101901925034,5936313125,275907117,1987526048,290445126,103889451082
20130307,101488438654,8464044001,274465533,1966923628,309917753,103455362282
20130306,99945597555,8520559834,299587767,2115377147,327014420,102060974702
20130305,98534885455,8155054783,279817534,2000673735,402108670,100535559190
20130304,97426076304,9066487513,232683604,1727135393,308220189,99153211697
20130301,95606134303,7320602629,262116842,1972673189,263260807,97578807492
20130228,94814148222,7990991763,286756914,2105272544,353484188,96919420766
20130227,94762628748,5775746098,259018993,1840023561,317130058,96602652309
20130226,94033826662,7658469765,239348529,1805074779,286012204,95838901441
20130225,92421928218,4784968168,251500918,1830456434,232553313,94252384652
20130222,91592282645,5317827763,230803646,1742091491,210726317,93334374136
20130221,91468231688,8401141942,249389678,1853586564,262302413,93321818252
20130220,90333744696,6361224934,302836704,2257186074,223244382,92590930770
20130219,89876334442,7886100852,313654098,2271718764,213396088,92148053206
20130218,87926525532,8842693426,335820575,2416617093,205111168,90343142625
20130208,84932368202,6812942439,329320025,2418021962,172759587,87350390164
20130207,86663004886,8580920767,366210902,2660619696,211824227,89323624582
20130206,85266773477,7874045216,455924139,3110879179,206983997,88377652656
20130205,83842570892,9474416050,470151254,3132341883,284032107,86974912775
20130204,82305911782,11251626666,508919726,3224025811,314655291,85529937593
20130201,79974275475,7920561619,520978774,3294340997,285848430,83268616472
20130131,80012584798,7429868873,533770933,3229530293,246998316,83242115091
20130130,79109519537,8022477919,542739932,3231189179,300927152,82340708716
20130129,77370649389,8032156123,524521539,3195250984,324575148,80565900373
20130128,75824006707,7217230263,488530667,3070041858,342789657,78894048565
20130125,74656422784,3835370531,409112298,2643745664,213678710,77300168448
20130124,74826755422,8055560610,443965934,2769072963,363638399,77595828385
20130123,74367360145,5642831418,452815961,2824296289,266353151,77191656434
20130122,73300956177,7837765200,484012406,2877985819,383004646,76178941996
20130121,71876409211,6561602308,467597658,2889135338,280265354,74765544549
20130118,70367079826,5755908405,422240885,2715427584,284914625,73082507410
20130117,70577250953,5886935810,401297868,2549583418,260767601,73126834371
20130116,69257047349,7447346465,427966270,2712346680,234712367,71969394029
20130115,68086057649,7691869725,462407649,2866456375,269803585,70952514024
20130114,66993937995,7911830846,450430887,2776368938,324599804,69770306933
20130111,65761864960,5721944752,428139149,2503842541,229860202,68265707501
20130110,65288113087,5763183125,482789420,2812446464,252995418,68100559551
20130109,64195114532,5722165174,473092376,2728892539,259417409,66924007071
20130108,63304834290,5640074918,470222324,2760964424,228406328,66065798714
20130107,62235629990,5443529030,496273481,2933725931,275217920,65169355921
20130104,60785480318,7407752903,468316259,2811995346,249165702,63597475664
20121231,59014161465,5633864416,490805859,2751605671,407517940,61765767136
20121228,59294670143,5297737080,386182354,2460898300,384019735,61755568443
20121227,59152544022,5373168743,361640747,2353661865,331518088,61506205887
20121226,58354981334,5114111979,376278216,2417109460,234225185,60772090794
20121225,57544359600,6368458672,388333500,2456222039,409792961,60000581639
20121224,57128889679,3788187865,333460818,2257004885,296162726,59385894564
20121221,56447787112,4689255807,307394734,2139542755,269920339,58587329867
20121220,55689600270,4484712392,326438956,2242931415,345922585,57932531685
20121219,54931071842,3768910786,349579396,2273481726,230855261,57204553568
20121218,54408074635,5151252842,337189498,2270274901,300649942,56678349536
20121217,53571995017,5541610549,330016054,2198213076,294180919,55770208093
20121214,52791881649,5843342497,307018627,2087408295,328393870,54879289944
20121213,52669288553,2246499161,288677886,1953468786,217352599,54622757339
20121212,52377520737,2687398378,317828422,2098295346,267006109,54475816083
20121211,51868905998,3125289600,306225400,2031576319,265454958,53900482317
20121210,51306934372,3401162233,313129159,2052661137,312883081,53359595509
20121207,51153092419,3742788183,273389625,1908057633,308254110,53061150052
20121206,51239355809,2710160062,245045308,1773461775,274816420,53012817584
20121205,50824143024,4221718658,260754780,1791669857,342048073,52615812881
20121204,50719310027,1668156873,247998486,1691394679,210297671,52410704706
20121203,50979389957,1746129421,231641500,1642665995,230229452,52622055952
20121130,51380781508,1715103966,213227459,1534954623,272225784,52915736131
20121129,51590830813,1428621103,216979129,1487427984,274952139,53078258797
20121128,51839015969,1430771351,200577797,1363891223,252283104,53202907192
20121127,52059352556,1561381214,195318232,1384086520,255616186,53443439076
20121126,52224867623,1322180521,187498079,1366826765,234474541,53591694388
20121123,52163842479,1543727769,184949966,1347840020,257859771,53511682499
20121122,52326315202,1332145449,172773106,1302639373,214932697,53628954575
20121121,52338359165,1943146103,184856026,1306569346,308581665,53644928511
20121120,52232906651,1509399872,166143592,1208322014,225334923,53441228665
20121119,52136377757,1674655573,166061919,1227615384,252906374,53363993141
20121116,51842436713,1662234177,164870960,1175452798,239594991,53017889511
20121115,51834437830,1585328945,181548847,1291515135,229951784,53125952965
20121114,51742932659,1519967699,193814073,1331110919,272000019,53074043578
20121113,51621569073,1885583091,190958378,1282131180,216004448,52903700253
20121112,51537026715,1767231895,194274310,1292540521,239937283,52829567236
20121109,51496481543,1478652032,158011064,1169277224,207705413,52665758767
20121108,51702911891,2055487490,156054457,1160802573,224975405,52863714464
20121107,51842199361,2051691468,159650300,1198477605,200321673,53040676966
20121106,51683392819,2421704753,159388987,1180023770,166281041,52863416589
20121105,51362279911,2316295635,165124083,1218018631,143928818,52580298542
20121102,51130702397,2343570856,163272076,1181065951,147342085,52311768348
20121101,51237157202,2617929839,159064788,1142165204,186500459,52379322406
20121031,51559113178,1692366022,141296023,1063191973,159333903,52622305151
20121030,51501871483,1589603973,137652090,1001355314,151389572,52503226797
20121029,51689038799,1584953781,122834403,927847068,128121470,52616885867
20121026,51310726506,2288657132,119586704,889943114,111326685,52200669620
20121025,50925458666,2168295969,146078286,1100159828,139550740,52025618494
20121024,50553991724,1887157124,154386431,1157441737,133866147,51711433461
20121023,50268571335,2284288793,159591985,1165651473,131752963,51434222808
20121022,49878708176,1994060503,164809687,1243452816,139669193,51122160992
20121019,49690327417,1848948756,149291084,1170027001,135684548,50860354418
20121018,49898366599,2447878705,172225102,1258697877,161104011,51157064476
20121017,50073315146,1926672446,156206434,1172942823,153853715,51246257969
20121016,49763747191,1844932312,147389523,1125348375,159267653,50889095566
20121015,49663180778,1691218706,142655629,1090407763,113395044,50753588541
20121012,49448638952,1908823608,129877794,1025770688,156486705,50474409640
20121011,49440483610,2225160985,141203222,1045817724,195813581,50486301334
20121010,48919543554,2279615232,131883103,1073263343,129690882,49992806897
20121009,48396852337,2764492399,133467259,1092153231,146184953,49489005568
20121008,48264741771,2310097195,119718461,969055748,115648046,49233797519
20120928,47592602099,2247164513,101326842,932013450,155872499,48524615549
20120927,48907506409,2351994804,107166059,931647214,184576201,49839153623
20120926,49560420336,1300488950,93606857,887941875,140129407,50448362211
20120925,49668053926,1347716776,90621853,910568341,119230488,50578622267
20120924,49922439548,1719001695,87540937,837518922,152475719,50759958470
20120921,49751841324,1769209667,85076142,816583676,139891973,50568425000
20120920,49793080866,2140705780,87505734,802087336,131210692,50595168202
20120919,49533570717,1837774603,86657532,814641345,123927878,50348212062
20120918,49256955701,1754116814,81366517,767029684,126572029,50023985385
20120917,49040117321,2558273294,94791540,817905616,146148054,49858022937
20120914,48670194775,2806237438,98193184,837191615,157294664,49507386390
20120913,48798184410,2208340317,96817302,830509365,127242730,49628693775
20120912,48462868314,2739662949,101052930,822985772,162310567,49285854086
20120911,47897803829,2580282922,110300855,796149061,110351985,48693952890
20120910,47126249677,3477138749,119591722,886484812,112440098,48012734489
20120907,46551429029,4336815591,126380751,899376929,227423483,47450805958
20120906,46734326953,1608727913,101604157,878206655,135899804,47612533608
20120905,46434490498,1632564950,94487151,866941167,125504126,47301431665
20120904,46165761015,1753553472,91707302,825213972,136972961,46990974987
20120903,45954941545,1669079983,90823674,816603315,110289744,46771544860
20120831,45671816226,1075961489,84120906,747149759,94804097,46418965985
20120830,45665093836,1463049036,87744523,740696134,129610280,46405789970
20120829,45764570771,1325562119,90901611,774751600,98202234,46539322371
20120828,45822985926,1503902531,101984574,806676314,147566751,46629662240
20120827,45733961176,1623650005,84369278,752748959,109171038,46486710135
20120824,45979785983,1394092725,74545452,739252012,91369039,46719037995
20120823,46197832033,1650535999,84030054,741581199,122034356,46939413232
20120822,46048682213,1477904628,75302638,712808353,73249776,46761490566
20120821,45866054150,1670213257,78030044,714370674,98054641,46580424824
20120820,45688473487,1336773539,70237773,687917590,79200693,46376391077
20120817,45527705227,1327191696,69860551,676251541,71407936,46203956768
20120816,45507584487,1199331627,69900322,704216605,54400821,46211801092
20120815,45370226843,1603184447,72983227,723991809,62266955,46094218652
20120814,45090974216,2023420057,72206532,705610508,97420910,45796584724
20120813,44805453973,2193592532,72005866,723520744,104164010,45528974717
20120810,44448470277,1847683090,74348094,775172979,80525607,45223643256
20120809,44655608409,2042616121,80495045,807873776,96060855,45463482185
20120808,44382355250,1651113021,81257626,811850790,82835499,45194206040
20120807,44381161170,1916815976,76336687,793858759,70258344,45175019929
20120806,43983961626,2086998476,82371958,803767457,99916973,44787729083
20120803,43644324473,1253402074,86148802,792848081,81031202,44437172554
20120802,43560657150,1272423989,109964795,892253942,102298268,44452911092
20120801,43473512880,1328778018,87744284,846108824,93231902,44319621704
20120731,43397313276,1164959004,87036316,819409782,95425038,44216723058
20120730,43600788260,1195213435,82041470,773619516,88269715,44374407776
20120727,43546606535,1164631708,82465871,776735174,90590906,44323341709
20120726,43605874770,1117458307,81310254,805110770,84741539,44410985540
20120725,43628637939,910461171,77500358,792767238,61189664,44421405177
20120724,43673831708,1164984697,78452436,794241045,74363842,44468072753
20120723,43520903617,1270199632,79265046,783217522,74122637,44304121139
20120720,43293277130,1377290396,75563457,801988558,81879998,44095265688
20120719,43133376716,1899781165,87830435,855940946,101789166,43989317662
20120718,43001260903,1706983756,87308300,815806529,94063890,43817067432
20120717,42850583006,1320741173,87962716,822312728,78146872,43672895734
20120716,42954857532,1612756321,82744142,837478653,63438603,43792336185
20120713,42995301769,1496117118,73569060,809010444,57872324,43804312213
20120712,42958440250,2685529361,86725318,825305762,81076191,43783746012
20120711,42763477754,1400213120,79346065,852955616,55472817,43616433370
20120710,42677890401,1526392426,72108460,790231037,51222842,43468121438
20120709,42433217425,2200692162,76491434,824026113,65970426,43257243538
20120706,42071500783,2161091737,71524787,809180403,55643954,42880681186
20120705,41980089686,1357113618,76724103,810716248,45976417,42790805934
20120704,41979741991,1502115984,83797944,859659598,54962884,42839401589
20120703,41775297474,1608081585,77988261,835347527,60616172,42610645001
20120702,41651551679,1764735984,78605198,807498588,57944152,42459050267
20120629,41352503305,1575175909,71843529,748286235,55266063,42100789540
20120628,41554211158,1419503922,65864694,699842311,41151998,42254053469
20120627,41452187393,1170928470,74432399,728466579,47294602,42180653972
20120626,41366843299,1329392155,70170803,664880194,55891667,42031723493
20120625,41328073117,1688930079,68561048,638598125,50582373,41966671242
20120621,41216039765,1827369234,72266373,667886102,58747926,41883925867
20120620,40971366211,1305051000,78687462,756005017,32590772,41727371228
20120619,40959301472,1610403138,83848906,737452012,50150367,41696753484
20120618,40774082626,1739591533,82028223,785854699,53460264,41559937325
20120615,40424538156,2362756170,76271115,752573261,61302167,41177111417
20120614,40463725268,1596178919,91731657,805817964,63646404,41269543232
20120613,40366154559,2136093851,88006249,804450614,75040967,41170605173
20120612,40118853209,1626998751,86829122,775286155,86560332,40894139364
20120611,39915091233,1777895999,71278581,708140329,69193516,40623231562
20120608,39719820736,1805598796,74578434,707825275,68552372,40427646011
20120607,39824344326,1889737375,80374882,693817796,55219901,40518162122
20120606,39585278444,1698621302,75901796,696908292,55559875,40282186736
20120605,39341792121,1627172086,79361897,693111890,72500316,40034904011
20120604,39201386102,2785005768,70592507,674920254,46517920,39876306356
20120601,38393016442,1909782134,82324321,741659426,48880185,39134675868
20120531,38363704389,2037759682,81459868,762840548,41239991,39126544937
20120530,37985520066,2248621352,96936518,837500845,56907028,38823020911
20120529,37676358273,2823201360,102682123,795978999,85831190,38472337272
20120528,37598761062,1930551399,100085549,770434631,79788676,38369195693
20120525,37535963602,1497066380,99344339,770189440,65466655,38306153042
20120524,37528312047,1988441593,109119638,814032820,48564343,38342344867
20120523,37072055664,1835455665,110405609,851734986,63951152,37923790650
20120522,37079833553,1671466540,101272872,792549634,62123968,37872383187
20120521,37126490787,1797956959,79977463,691025268,70327136,37817516055
20120518,36821357488,1888308119,79483011,650247666,48150091,37471605154
20120517,36787680964,1962619901,98072503,715905627,72488823,37503586591
20120516,36779217694,2178812217,82716723,646127083,54455563,37425344777
20120515,36152562663,2036097511,76164785,655470335,44423368,36808032998
20120514,35628803242,2461641937,83330079,626430094,58276789,36255233336
20120511,35115705765,1960511506,72634354,618124665,52964430,35733830430
20120510,35040860645,2161721639,70736344,622693679,46438814,35663554324
20120509,34451948648,2651766271,70429182,625816606,31970137,35077765254
20120508,33893622504,2441135022,89363763,722745535,46747769,34616368039
20120507,33467500884,2716734348,93667450,728200355,47121086,34195701239
20120504,32929079712,2390138078,94427325,793584355,44620428,33722664067
20120503,32914444024,2695216589,100602257,797696945,55100759,33712140969
20120502,32374252299,3738262191,102616917,762654074,96784966,33136906373
20120427,31996092316,1870375931,75102834,652371267,44197746,32648463583
20120426,32207563433,2491763979,92790440,711808798,61307519,32919372231
20120425,32022808570,2546857177,95956860,733448615,77263596,32756257185
20120424,31886526859,2842912506,89615736,698699325,100606915,32585226184
20120423,31919290664,2418725607,93581898,740475666,33113154,32659766330
20120420,31697962487,2307629393,107583581,799575812,65626841,32497538299
20120419,31763708953,2086454193,95252379,745588191,36252010,32509297144
20120418,31713063485,2056222445,94973520,742347355,68153995,32455410840
20120417,31701763328,1522188706,75021384,644509653,28548563,32346272981
20120416,31551930384,1690206798,99357507,745742224,40483930,32297672608
20120413,31321457781,1929005224,103454520,724919491,42290928,32046377272
20120412,31658371384,2069068142,99941076,728861977,80194978,32387233361
20120411,31650530805,1620531132,79068442,637539984,55313390,32288070789
20120410,31315108010,1442581118,73810230,613613548,80355809,31928721558
20120409,31312683905,1263660302,68770210,637822011,47806726,31950505916
20120406,31203189503,1556670352,73395741,638010186,46986690,31841199689
20120405,31036889547,1910713961,64586644,612979847,56598239,31649869394
20120330,30855059829,1118746389,56193346,498505368,62941195,31353565197
20120329,31466692094,1468201404,44127042,451280109,46667617,31917972203
20120328,31725359177,1803704771,48674164,472971028,42376494,32198330205
20120327,31652995174,1639570640,49559003,506940846,27388022,32159936020
20120326,31310255462,1024520698,46497850,500457946,23866413,31810713408
20120323,31324525878,1588669351,48785242,501264079,26483738,31825789957
20120322,31258610141,1552432938,57970650,539410434,31317968,31798020575
20120321,31184318827,2250811673,54813928,524894386,35619553,31709213213
20120320,30881415456,2213237546,56871972,538233515,30913007,31419648971
20120319,30589579776,2323158537,56181903,578814778,27401075,31168394554
20120316,30040251162,1990283308,54580030,560756438,28742946,30601007600
20120315,30030622336,2615937639,59941649,553397981,32707021,30584020317
20120314,29962495014,3971920425,69025989,583607249,49997459,30546102263
20120313,29506123404,2090953160,69587560,650512180,26611167,30156635584
20120312,29313541336,2466695709,67451971,624485011,21119382,29938026347
20120309,28698907823,2039557422,68860749,627719200,27333645,29326627023
20120308,28553279578,2004963445,65148944,617717954,30877433,29170997532
20120307,28322835473,2037715180,60969711,572080706,27513496,28894916179
20120306,27925437822,2260379699,57613626,576731626,22969708,28502169448
20120305,27545673775,2328139500,69480404,661468241,23245402,28207142016
20120302,27048735068,2290381860,68726983,651310699,32257235,27700045767
20120301,26693098407,1544104350,66158703,599587277,18384913,27292685684
20120229,26421186475,2001683188,69376741,618905567,21241505,27040092042
20120228,26173607268,2196625510,87665091,723104224,35380084,26896711492
20120227,25953096751,3344833427,84073278,749953321,40228327,26703050072
20120224,25607219924,2713861391,79216645,715901888,38356889,26323121812
20120223,25509973452,2185981378,74545206,658672185,29827061,26168645637
20120222,25223728541,2434752756,71213515,648311438,33399169,25872039979
20120221,24969797018,1563224989,67474234,604735691,28384179,25574532709
20120220,24772829932,1759766700,67006375,579980747,25030078,25352810679
20120217,24478237341,1179539111,67342330,576582374,21536477,25054819715
20120216,24491754154,1582477398,67354573,590145157,29591666,25081899311
20120215,24179753364,1781362196,70206203,601734232,33021804,24781487596
20120214,23860965648,1256560815,67425776,579118989,21818417,24440084637
20120213,23608213305,1582126178,74001887,607362447,27428688,24215575752
20120210,23186699954,1445006748,77934173,644878993,37539934,23831578947
20120209,23364280534,1737119914,73917036,614904727,24235925,23979185261
20120208,23304347745,1565565996,76405228,626032158,42850739,23930379903
20120207,23313248252,1445701790,67519882,547716962,23234560,23860965214
20120206,22784517940,1343935156,79203248,647383244,30082272,23431901184
20120203,22515446802,1520410924,72249383,614937122,28466238,23130383924
20120202,22396236472,1178861936,74944712,616095248,40883119,23012331720
20120201,22366485298,1285617462,62171415,499224550,29621146,22865709848
20120131,22014346641,1044338505,65089079,516870389,25851288,22531217030
20120130,21653344631,1502767818,61608639,517342115,27449182,22170686746
20120120,21088647331,1142179973,55586416,465817218,26347917,21554464549
20120119,22161798417,1384432993,55687161,469400533,34258703,22631198950
20120118,22564638461,1581544852,58523016,462490757,27677343,23027129218
20120117,22582606058,1651314781,58887823,472151600,44605354,23054757658
20120116,22638911372,878056969,55948078,482314622,23390485,23121225994
20120113,22674391245,1133649934,53783886,472373707,32020707,23146764952
20120112,22781226572,1231619261,55347593,518981025,25652667,23300207597
20120111,22869720240,1274706955,54570044,484380898,22465195,23354101138
20120110,22773950655,1701133654,60754782,542466054,36201132,23316416709
20120109,22853440665,1130784004,53940103,493659623,36755697,23347100288
20120106,22974795499,825709884,46360925,424102079,28232074,23398897578
20120105,22871007499,794286091,50717382,442507556,33093226,23313515055
20120104,23086161879,788064877,46400139,420191819,23909849,23506353698
20111230,23163493473,762689122,42775775,381308271,16111293,23544801744
20111229,23261484479,635606065,41815062,376407550,20787029,23637892029
20111228,23227075749,640946990,39661774,363621020,26680606,23590696769
20111227,23125457645,595501546,42098722,404473909,22763301,23529931554
20111226,23097117469,581463956,44732221,416766360,25980338,23513883829
20111223,23022628028,606711079,37405942,376194331,23217806,23398822359
20111222,23156209497,712315873,37859438,379727180,25005463,23535936677
20111221,23213182571,747255578,37184408,377163348,20155441,23590345919
20111220,23215304975,728256469,34861389,360845947,15958852,23576150922
20111219,23160945470,822981905,33105978,332957773,24292388,23493903243
20111216,22960970432,860810024,30758385,305995652,21208854,23266966084
20111215,22829426940,963186538,28592270,272303088,21056484,23101730028
20111214,22710676753,632941142,35419573,330633736,18636350,23041310489
20111213,22643584951,833397363,32193838,307393822,18470026,22950978773
20111212,22525065787,554603321,33629217,347531224,14426092,22872597011
20111209,22507138358,566831017,31101894,331965565,12314384,22839103923
20111208,22528992922,675914693,31650642,348107592,13511857,22877100514
20111207,22449261088,604856537,32517630,355100811,12002880,22804361899
20111206,22413359472,596412942,30294629,323513134,12894247,22736872606
20111205,22379650562,875782534,28770860,285651059,11485770,22665301621
20111202,22267766625,591659988,25798251,286192505,11811426,22553959130
20111201,22299466764,1146806646,31414320,323600241,23831887,22623067005
20111130,22466452028,671042821,25789420,251839752,13718818,22718291780
20111129,22518644243,523651456,23939304,243157210,6499083,22761801453
20111128,22494897616,416782437,23766060,237443922,8508862,22732341538
20111125,22400850427,378427898,24411174,229398872,6142342,22630249299
20111124,22421973306,533808677,26046976,222336516,10427210,22644309822
20111123,22381342035,531977490,25511851,226185197,7883063,22607527232
20111122,22340596474,525422181,25818227,222145112,10996422,22562741586
20111121,22261866663,559758089,22621233,199896201,6876944,22461762864
20111118,22128264632,780915845,24522714,222239814,10335910,22350504446
20111117,22110549167,648788840,26273433,227849268,7134576,22338398435
20111116,22079287311,1219956202,26259470,239721422,9295086,22319008733
20111115,21642895602,779370039,27080435,273247991,7269674,21916143593
20111114,21472109836,975365770,26773711,283122754,10944894,21755232590
20111111,21345143945,522265203,21814465,228553808,6117291,21573697753
20111110,21382370001,988495911,24396868,251366496,8554810,21633736497
20111109,21137377041,941665090,26167383,274341766,9004068,21411718807
20111108,20904972932,899090697,26772166,282879218,10627240,21187852150
20111107,20693207005,948486415,26955213,291959397,9635057,20985166402
20111104,20425574366,1033452397,26947593,313367437,8369940,20738941803
20111103,20365235328,1715745986,31206137,350922118,12683294,20716157446
20111102,20094724795,1186052906,29986982,324025976,16013940,20418750771
20111101,20008002941,1034962228,26987151,311177544,13416001,20319180485
20111031,19901349449,848254260,28142824,289607069,12563771,20190956518
20111028,19749284408,1317088917,24563599,280412541,14722998,20029696949
20111027,19930731684,866055881,25870085,269320285,8478125,20200051969
20111026,19786668727,1186801201,25867196,278027139,11895931,20064695866
20111025,19857163052,1013477891,27805778,275098742,11529889,20132261794
20111024,19813181984,665327297,29481990,277010395,16458480,20090192379
20111021,20077609862,435631187,21500417,211420624,8870038,20289030486
20111020,20274135425,763089420,19965227,202598780,12806994,20476734205
20111019,20242841224,560816548,21272854,214840500,9326280,20457681724
20111018,20246908676,767490712,20821522,201356530,9000481,20448265206
20111017,20300361995,615448397,22424092,224636776,9809467,20524998771
20111014,20400802814,566964409,18130701,173236358,7224172,20574039172
20111013,20543903238,1004156009,19387268,189604710,10184680,20733507948
20111012,20430753257,1268675776,20463760,197808881,17590680,20628562138
20111011,20324309699,818716848,16966515,164383113,14579542,20488692812
20111010,20500158665,563518759,13608090,127729044,6471754,20627887709
20110930,20678257223,492770036,10440824,103619722,5937150,20781876945
20110929,21137792643,607797098,11299531,114029122,8060878,21251821765
20110928,21285200989,589898985,14122313,138656353,8666246,21423857342
20110927,21442994144,798225193,13724995,137037016,8993687,21580031160
20110926,21304984798,770319061,14219544,139292010,10197700,21444276808
20110923,21359329274,725289704,13089962,120866382,8825812,21480195656
20110922,21403223921,1069294786,14441300,130053405,4620321,21533277326
20110921,21080852830,954136977,21524918,206591595,12898976,21287444425
20110920,21181592617,498228852,14239386,143514609,5818837,21325107226
20110919,21103835093,477718941,15411506,149393710,5293501,21253228803
20110916,21020934154,481260309,14739963,152059454,3733105,21172993608
20110915,20996390466,520749456,15301780,153849633,6723858,21150240099
20110914,21050929175,578762129,13571790,141502534,8655411,21192431709
20110913,21122136936,496754054,13236777,135897276,5736074,21258034212
20110909,21041870266,456447707,11242329,123040515,4718266,21164910781
20110908,21114896834,426969613,11230126,119523196,2851131,21234420030
20110907,21042304936,545203523,13341862,137647700,7934344,21179952636
20110906,21068944086,538935703,15441020,140792805,6705595,21209736891
20110905,21003486998,544363500,15756419,151286436,4891217,21154773434
20110902,20901163881,513088861,15842578,148371813,4677930,21049535694
20110901,20898889032,591419508,16459049,170124255,6978877,21069013287
20110831,20893312611,631883913,14817593,156151205,5352129,21049463816
20110830,20749898186,941988987,15575374,144874603,8519795,20894772789
20110829,20496342307,924883740,14198005,138195444,6936504,20634537751
20110826,20109341830,779339684,14260666,144852223,4749623,20254194053
20110825,19909811437,1096244617,18118303,178337878,19696022,20088149315
20110824,20148223867,612218009,10600253,124292110,4595203,20272515977
20110823,20161763673,533358619,10029143,119578438,5461264,20281342111
20110822,20104631668,558701490,9545426,105877958,3715579,20210509626
20110819,20074117205,651203376,9616532,105792568,5616951,20179909773
20110818,20125765773,551565624,9341227,102841701,2849491,20228607474
20110817,20020240955,543389929,11401958,121490686,5960696,20141731641
20110816,19938522613,667246061,11029909,119343076,5334915,20057865689
20110815,19900155759,753176441,12740168,138610368,7811496,20038766127
20110812,19780555772,613786247,8721815,100761200,5604528,19881316972
20110811,19853845619,734314619,10015140,118858307,9749563,19972703926
20110810,19891797252,722853204,8164476,102750046,6358839,19994547298
20110809,19958893276,928507380,8510822,103220280,9821263,20062113556
20110808,19965951464,1069167394,6228649,84548175,6829971,20050499639
20110805,19903220315,732342442,6236968,81846166,4610775,19985066481
20110804,19916978654,425657196,6177709,88632479,1934766,20005611133
20110803,19947338610,517125110,6009484,84927100,2512125,20032265710
20110802,19875147783,587232237,5634766,80459862,3827179,19955607645
20110801,19710659516,526493233,6757289,94262148,3564907,19804921664
20110729,19559824766,599191915,7444958,99044215,7700455,19658868981
20110728,19687768485,729220145,6158003,89444658,2856995,19777213143
20110727,19723552899,710416333,7058607,91618285,4154342,19815171184
20110726,19521197009,600132078,6979343,91989898,4838398,19613186907
20110725,19407400892,1223685970,7053850,90912525,5661279,19498313417
20110722,19089884281,538622268,8038123,109482316,2046281,19199366597
20110721,19064469706,794485438,7927616,103321745,2763768,19167791451
20110720,18904053734,753245170,8025978,104270653,2273105,19008324387
20110719,18721052787,869512293,9226150,116105702,4966708,18837158489
20110718,18533214237,938114982,10626146,118284743,4400937,18651498980
20110715,18253511171,898096392,11091762,124866183,4445765,18378377354
20110714,18255187388,941410724,10004823,118056602,7088673,18373243990
20110713,18208652416,810911250,8339733,107247652,4194816,18315900068
20110712,17997153779,882517355,7666637,96865179,1397483,18094018958
20110711,17917092953,703189744,9106733,120987808,2281816,18038080761
20110708,17776243573,836312390,9576651,123145684,3327510,17899389257
20110707,17758752144,1120177136,10090018,128926937,5285068,17887679081
20110706,17663982481,986207992,8978645,120444365,2794260,17784426846
20110705,17383762436,922968515,11443964,138735839,4495776,17522498275
20110704,17323611660,1166307857,12854616,152657402,5022068,17476269062
20110701,17284258925,924432426,9895063,126466709,3314300,17410725634
20110630,17124281108,1040052866,11193673,131300405,5586823,17255581513
20110629,16809796611,858850391,11266552,120598921,4031312,16930395532
20110628,16606989920,808099694,12446374,140407937,5449689,16747397857
20110627,16488029126,875088965,11729864,136963765,3819564,16624992891
20110624,16292288301,1246001461,12614137,139250514,7404590,16431538815
20110623,16344099381,590474443,10385270,127163624,5572437,16471263005
20110622,16340605968,458576650,8562699,110372758,3246944,16450978726
20110621,16298026991,556172998,8746775,108578882,4500981,16406605873
20110620,16237528175,684553790,7041289,84482812,4208224,16322010987
20110617,15996336369,543788365,6893626,85261149,3206708,16081597518
20110616,16725857941,548958255,6380948,80625517,3149921,16806483458
20110615,16604120197,681522651,7176378,92799285,2954550,16696919482
20110614,16495870887,632876203,7462570,96724997,4647154,16592595884
20110613,16526574094,461222722,7313918,89785589,2794483,16616359683
20110610,16706872250,510782266,6829387,87414402,3503615,16794286652
20110609,16652969254,536559008,5502362,77298236,1354205,16730267490
20110608,16637485175,652215529,5936404,82207141,2297381,16719692316
20110607,16632529204,494847936,4933489,71988989,1125846,16704518193
20110603,16651911918,429223785,4572371,69985984,1436302,16721897902
20110602,16686353331,707660792,4478362,71607044,2568570,16757960375
20110601,16497676967,429816133,5753115,86503868,1261193,16584180835
20110531,16438326942,605991887,6405088,82236507,2723857,16520563449
20110530,16213113108,405172307,6559796,81285713,2173872,16294398821
20110527,16191808615,353444434,5550782,72613616,3297768,16264422231
20110526,16341680214,355960669,6033407,78006622,2108777,16419686836
20110525,16283881810,452351034,6097604,79638143,2105200,16363519953
20110524,16214417437,435565589,5842578,81266047,2168465,16295683484
20110523,16098875769,583648042,4944670,71963942,1974913,16170839711
20110520,16152695129,388182430,5823957,83657525,1343500,16236352654
20110519,16077648730,457940932,6641537,87460100,2057864,16165108830
20110518,16108290447,488478494,5823070,76216406,1213983,16184506853
20110517,15929011870,531243729,6135784,77901100,3172339,16006912970
20110516,15719819800,429035133,5888151,77105086,1494117,15796924886
20110513,15708129071,839978633,5952900,77440669,2347153,15785569740
20110512,15577419319,637723841,7396415,79021693,2865176,15656441012
20110511,15401083312,446166522,6848453,84911516,2034728,15485994828
20110510,15395985663,549641025,8506550,95339354,4009762,15491325017
20110509,15232374677,655677577,6954166,79239553,3053830,15311614230
20110506,15121981644,575024359,7884402,79037225,3168270,15201018869
20110505,15244339467,517842819,8093045,74631038,4013594,15318970505
20110504,15343903210,720446025,9876674,90450206,6684147,15434353416
20110503,15460738148,576526525,8520054,79822417,4452343,15540560565
20110429,15489352748,660353548,7108920,77939727,5409610,15567292475
20110428,15496163903,816293853,6300953,69131777,3717515,15565295680
20110427,15650190523,700835759,6616761,70066258,2820572,15720256781
20110426,15631632543,607506192,9058682,81107842,2767526,15712740385
20110425,15674614639,831491973,10324778,88110797,6829894,15762725436
20110422,15747595484,793020974,6733335,73647335,2122066,15821242819
20110421,15678896887,891476736,6904789,74874951,3852804,15753771838
20110420,15422476966,974222845,5668500,66104465,3303600,15488581431
20110419,15113883362,833387870,6761054,71154456,2117258,15185037818
20110418,15115565632,1078745597,7706571,81851545,3249509,15197417177
20110415,14964312035,907993468,7011864,79992980,4872515,15044305015
20110414,14893886634,1055293369,6117783,77139044,2627953,14971025678
20110413,14822054819,1279809135,5703039,79253489,1932786,14901308308
20110412,14507155762,1382760835,8994317,89657042,5225243,14596812804
20110411,14042989427,1624611942,7216389,91166318,2178560,14134155745
20110408,13663436042,987464836,7076922,90126072,1459031,13753562114
20110407,13456816257,1083025717,9643279,114503907,2837584,13571320164
20110406,13311929130,1453562222,9962181,116722118,5630068,13428651248
20110401,13397963410,926784061,5728654,63330615,4045524,13461294025
20110331,13389814034,957692779,5412348,62935430,4025546,13452749464
20110330,13114336973,971615362,5501314,68312126,3531533,13182649099
20110329,13000571572,1392433791,7308035,84735680,6399488,13085307252
20110328,12747132404,1099208957,3649954,49224109,2724000,12796356513
20110325,12645793482,872828184,3599329,58416102,2152467,12704209584
20110324,12569889147,652630190,3981062,68362920,1179932,12638252067
20110323,12473138104,784408790,3867230,62197982,1280206,12535336086
20110322,12389914708,611897421,4029430,66353212,2623142,12456267920
20110321,12286615929,663574647,3119346,53508592,1095180,12340124521
20110318,12177302266,573637847,2822995,52352121,644890,12229654387
20110317,12128220239,761298186,3190921,55122334,2079084,12183342573
20110316,12214737047,892411036,4176678,60619177,2859423,12275356224
20110315,12234504116,911628602,3187169,53807370,2658107,12288311486
20110314,12144451877,557513061,2278770,35723632,462300,12180175509
20110311,11973484849,745190335,3072279,41932876,1026502,12015417725
20110310,11749387072,849626386,3864903,55875733,1989364,11805262805
20110309,11615540852,801429978,4563041,75334080,2824714,11690874932
20110308,11521780981,904709041,4265229,71401857,1756246,11593182838
20110307,11378560775,1337038695,4776797,77652784,3075421,11456213559
20110304,11147027377,747928982,3154893,45941862,2749980,11192969239
20110303,11046130055,1019788440,4413327,57169330,4624908,11103299385
20110302,11009415972,808798087,1761509,23705832,1752220,11033121804
20110301,10924143093,769595277,1498840,22389292,1456341,10946532385
20110228,10886936320,675667868,1156621,17100603,1615160,10904036923
20110225,10858082464,692267202,932791,16338957,1283484,10874421421
20110224,10796619793,794570977,1308597,17262748,1806055,10813882541
20110223,10619583455,647426365,972043,14897624,1245891,10634481079
20110222,10525272993,1001895274,1431301,15915330,1988907,10541188323
20110221,10315577822,767670898,1020144,11621281,647958,10327199103
20110218,10157728964,647287468,1139340,11894180,517100,10169623144
20110217,10032421759,955054160,1174063,12102813,586242,10044524572
20110216,9792654830,847457177,1199053,13686326,377000,9806341156
20110215,9596234682,860216663,1274273,14779112,730800,9611013794
20110214,9715701377,915382728,1398773,17152769,895000,9732854146
20110211,9771176484,512505121,863773,10218163,183570,9781394647
20110210,9740914093,491495815,1092573,13778369,430809,9754692462
20110209,9589509907,529461387,999913,12714493,858828,9602224400
20110201,9402454012,392394929,961205,12960401,673100,9415414413
20110131,9583910868,632364871,1528405,15715553,989600,9599626421
20110128,9469502833,447644390,1277756,12840273,515000,9482343106
20110127,9429095585,695694010,1315956,12945773,1377700,9442041358
20110126,9349795135,389519420,808236,9365923,544400,9359161058
20110125,9220062356,346162375,689771,9333398,361280,9229395754
20110124,9177837418,509692127,896102,9228124,1250571,9187065542
20110121,9102872273,540497532,554580,7299859,1357900,9110172132
20110120,9086647897,497827964,456911,6614513,591600,9093262410
20110119,9087977825,462920729,555611,7280845,532300,9095258670
20110118,8981757570,405004924,588226,5909762,515500,8987667332
20110117,8821400941,443218144,809973,7448751,840392,8828849692
20110114,8769493796,379638726,702858,6913532,423910,8776407328
20110113,8754029313,367484313,781358,11325427,249101,8765354740
20110112,8710801634,401466452,854548,10147082,571040,8720948716
20110111,8667104852,355611110,897535,10944904,708474,8678049756
20110110,8758781466,560718946,550461,6997014,546062,8765778480
20110107,8690038014,626845747,690326,9286568,1202003,8699324582
20110106,8727223150,509404270,326823,4413921,377620,8731637071
20110105,8596471915,631058464,292089,3737827,274600,8600209742
20110104,8516136811,727620536,437889,6276423,564533,8522413234
20101231,8427486678,601063229,196184,4103136,364366,8431589814
20101230,8220105721,373192568,370068,6870974,913880,8226976695
20101229,8146359995,351203051,271488,5575964,353640,8151935959
20101228,8010109091,405320013,269648,5729010,674382,8015838101
20101227,7980334051,568941962,642745,7669058,1192141,7988003109
20101224,7897318010,392595142,432130,5257608,430600,7902575618
20101223,7817500749,375027731,659106,8295867,725400,7825796616
20101222,7776178311,569147197,384706,4995923,627562,7781174234
20101221,7564667757,622556317,550844,7898275,757944,7572566032
20101220,7435701311,396781734,872930,9139721,1300196,7444841032
20101217,7493201511,245814175,307505,3888480,436200,7497089991
20101216,7542711921,448723342,506199,6987252,621900,7549699173
20101215,7462794030,542387127,539843,7096652,646067,7469890682
20101214,7373777616,598845377,1274597,12452885,1185359,7386230501
20101213,7209404871,1038828767,841438,11021133,1088500,7220426004
20101210,6644591506,385958637,409938,5320758,604287,6649912264
20101209,6527614801,590322354,621644,6716150,648581,6534330951
20101208,6287597522,397789735,394437,4904499,452850,6292502021
20101207,6265658521,452005783,391987,6328242,708000,6271986763
20101206,6164097438,382055879,464227,7827321,430100,6171924759
20101203,6090572316,329387031,1749408,13480634,317400,6104052950
20101202,5997821790,308030176,1913976,14683623,517948,6012505413
20101201,5937744337,263690928,1900828,13522674,544289,5951267011
20101130,5936566231,372617460,1820641,13391922,757715,5949958153
20101129,5929259556,293264104,1809826,12689598,1604077,5941949154
20101126,5903402929,329668655,514357,7255734,440380,5910658663
20101125,5970633357,554239093,533304,8944840,191600,5979578197
20101124,5822662043,435812235,417648,5899263,97800,5828561306
20101123,5739500620,287201446,514748,7526229,229000,5747026849
20101122,5719559877,469767361,372748,4784637,80200,5724344514
20101119,5603612499,307385398,453648,5957617,358538,5609570116
20101118,5825398138,358203003,272732,3358346,254548,5828756484
20101117,5816759463,492329349,340200,4704616,387448,5821464079
20101116,5759550131,502106601,188608,2722873,279700,5762273004
20101115,5777852641,640509031,346400,5068891,191576,5782921532
20101112,5535208139,697482878,422600,6708001,586997,5541916140
20101111,5772737492,808783051,393223,8561789,225200,5781299281
20101110,5669380056,742219805,376923,9812493,146123,5679192549
20101109,5427122250,673362671,496500,8898349,238736,5436020599
20101108,5205338554,747835334,690318,12687718,321475,5218026272
20101105,4878634897,845292430,610189,12221523,147200,4890856420
20101104,4687431943,616399880,608489,11538012,370710,4698969955
20101103,4579337355,644200987,540018,10323308,328300,4589660663
20101102,4470409233,771255747,393200,8514685,498653,4478923918
20101101,4341749551,498627782,491400,10079811,200210,4351829362
20101029,4296990516,459821357,399600,8471305,245900,4305461821
20101028,4324880974,447080074,558536,11504878,307300,4336385852
20101027,4269896802,614699304,563562,13273825,427230,4283170627
20101026,4071030302,659869062,642432,16896360,311600,4087926662
20101025,3936580107,738284867,486332,15947408,88900,3952527515
20101022,3755121466,479643761,475332,15181865,41300,3770303331
20101021,3596853448,449387902,677432,18477168,91500,3615330616
20101020,3449163925,748459214,933337,21142887,194000,3470306812
20101019,3288583583,556393938,928137,19002447,203621,3307586030
20101018,3152329327,777043254,940407,17962007,285274,3170291334
20101015,3074262298,763331295,1124694,20101316,669000,3094363614
20101014,3012610812,643408502,1183133,22358972,645300,3034969784
20101013,2945491873,511670532,739533,15999257,387000,2961491130
20101012,2911633870,466185821,465533,12313951,123100,2923947821
20101011,2854342169,540431173,397333,11346296,234200,2865688465
20101008,2879844623,352236845,251233,8043235,116900,2887887858
20100930,2846908595,230489640,187545,5757722,50300,2852666317
20100929,2821582317,163401189,182345,4995213,26200,2826577530
20100928,2795750305,142460313,206845,5524300,1200,2801274605
20100927,2778508977,162672915,214245,5760387,4500,2784269364
20100921,2724501690,73780692,233745,6292451,15500,2730794141
20100920,2736068769,127859806,233945,6277730,48100,2742346499
20100917,2668066420,117420810,206545,5944573,30600,2674010993
20100916,2631809132,129223608,204045,5954733,33100,2637763865
20100915,2614204191,128825123,196745,5674825,17600,2619879016
20100914,2618194471,122089778,201445,5944824,32200,2624139295
20100913,2621304462,192569363,257645,6631071,9700,2627935533
20100910,2568640986,103135866,278145,6690296,96100,2575331282
20100909,2568993058,228372953,228045,5937879,63600,2574930937
20100908,2493160533,213749417,349545,6860345,60900,2500020878
20100907,2414136562,134071867,489245,8658064,115100,2422794626
20100906,2387662569,184925685,468544,9436998,80100,2397099567
20100903,2347176762,143306467,436544,6786496,55200,2353963258
20100902,2367547449,198711616,425345,7587947,95300,2375135396
20100901,2322415396,165106740,469945,8972215,110300,2331387611
20100831,2307041382,154108208,521045,10113191,255200,2317154573
20100830,2285460219,177968857,305845,8624182,71300,2294084401
20100827,2220473978,88446491,523445,9352048,23800,2229826026
20100826,2194536639,76108498,572045,9607119,155600,2204143758
20100825,2190791657,98774816,458789,9046741,169156,2199838398
20100824,2213911577,143827323,383389,9111951,105200,2223023528
20100823,2141737847,113225964,341633,8364909,116500,2150102756
20100820,2116441794,140901472,267833,7995830,81260,2124437624
20100819,2111575425,204734599,386833,10610725,133500,2122186150
20100818,2085438731,136209711,335533,9108477,162900,2094547208
20100817,2052174441,137843946,309233,8541510,43700,2060715951
20100816,2011265809,163870333,373733,9432818,68800,2020698627
20100813,1946004866,104210434,346333,9002846,52900,1955007712
20100812,1917657100,97853482,389033,9417267,111600,1927074367
20100811,1903636176,94087853,343633,8956495,31900,1912592671
20100810,1869121672,147571316,398133,8994919,100400,1878116591
20100809,1841103737,125992494,393533,9550619,121100,1850654356
20100806,1802240599,111988470,305433,8124270,57000,1810364869
20100805,1775576845,167459563,287233,8153166,22700,1783730011
20100804,1709199891,126248395,336784,8847500,72900,1718047391
20100803,1664552954,129466269,512284,10911462,89600,1675464416
20100802,1640972044,174443309,473984,10476961,48800,1651449005
20100730,1552855454,92133368,501984,11038366,27800,1563893820
20100729,1531824312,98484393,566584,12045927,97800,1543870239
20100728,1583742413,108644824,585884,12138814,110851,1595881227
20100727,1580807913,79519953,657933,12761026,42300,1593568939
20100726,1551684452,71587341,662543,12879111,194500,1564563563
20100723,1539431335,149445421,540743,11236586,84000,1550667921
20100722,1498641789,89420614,516133,10950510,21800,1509592299
20100721,1472317314,100091861,508033,10765589,35000,1483082903
20100720,1440850708,212954187,612483,12001535,123700,1452852243
20100719,1303905018,71278412,611033,11856372,88900,1315761390
20100716,1319305043,47955270,578433,11100827,63100,1330405870
20100715,1287501800,60785184,584433,11102706,34500,1298604506
20100714,1263477734,80227880,646733,12064921,156700,1275542655
20100713,1311949508,122088757,632033,11843759,92400,1323793267
20100712,1222983113,122496033,583333,11397184,51100,1234380297
20100709,1170639291,157020933,561433,11009953,141000,1181649244
20100708,1102548838,65542507,493933,10084050,126900,1112632888
20100707,1064383786,44925331,466733,9798533,116400,1074182319
20100706,1057442951,59076920,444633,9638251,116200,1067081202
20100705,1035344028,118587870,428744,9394483,104096,1044738511
20100702,946500624,55619277,435344,9352154,123700,955852778
20100701,928736463,42612154,435844,9185768,123100,937922231
20100630,908521076,35114468,327344,8247937,149700,916769013
20100629,901933545,56320628,365444,8772089,153911,910705634
20100628,907046989,52375764,393079,8937135,115300,915984124
20100625,877045659,30535042,361467,9449157,139803,886494816
20100624,866091036,47947796,346051,8977774,55200,875068810
20100623,842719148,47607058,364651,8465580,44600,851184728
20100622,867189284,42295789,413651,10065984,29900,877255268
20100621,859456754,99484877,414051,9530834,204100,868987588
20100618,819295645,46482526,298251,5861101,63541,825156746
20100617,802191743,35258695,334518,6931429,41900,809123172
20100611,782619926,44972146,334618,7216554,56218,789836480
20100610,793255677,41796850,347231,7456056,105400,800711733
20100609,785253681,126771313,409431,9413470,281700,794667151
20100608,697311113,34230923,241031,4737840,87500,702048953
20100607,685693950,28140634,281931,6756505,98200,692450455
20100604,680721701,31729497,2472131,14822564,119400,695544265
20100603,675126222,38752924,2434617,14194808,147786,689321030
20100602,653397284,27207650,2342631,12525827,44600,665923111
20100601,639998626,41486233,2343493,12838683,435931,652837309
20100531,629837529,37471239,1974600,10343585,1810900,640181114
20100528,633696229,56487576,239300,4162822,45000,637859051
20100527,604281887,69689203,310600,5436101,26200,609717988
20100526,565966886,17672866,474000,9060668,48300,575027554
20100525,562759014,56337279,485200,10017758,146900,572776772
20100524,534671504,76158631,1559490,14057930,1226200,548729434
20100521,503728469,51052980,389690,8942658,346500,512671127
20100520,486806982,32023540,768093,9010047,727990,495817029
20100519,475810742,28129781,374900,5307357,224067,481118099
20100518,467622771,32532723,291000,5137036,135000,472759807
20100517,473201524,74027562,304500,4442929,24200,477644453
20100514,415983876,43883229,391106,6807124,296106,422791000
20100513,393357604,43516642,420400,8409102,156800,401766706
20100512,376113669,43090277,357000,6718753,246200,382832422
20100511,350667983,47067392,302868,6053063,144200,356721046
20100510,327370089,36414703,310636,6273327,181436,333643416
20100507,309938569,48359014,204363,4275122,59300,314213691
20100506,314003383,55666699,183263,3286323,15400,317289706
20100505,277495916,50597915,286963,5144755,101100,282640671
20100504,242846863,21944030,200763,3519010,116400,246365873
20100430,235526412,27804556,130863,2551528,20400,238077940
20100429,233030157,27561491,137763,2847328,12363,235877485
20100428,223249365,31144701,136600,2709735,2100,225959100
20100427,202494937,29621581,142500,2758191,76000,205253128
20100426,182090321,35141973,278900,11042183,193800,193132504
20100423,152902064,17574818,137600,2830321,15700,155732385
20100422,157219058,32603174,135400,2932237,192400,160151295
20100421,127565065,14384413,110300,2513143,97300,130078208
20100420,116673356,5706716,33400,1638860,525900,118312216
20100419,112783831,8395193,22000,1031561,1500,113815392
20100416,121064474,25841176,24500,1198858,19300,122263332
20100415,103099287,20916787,6200,271214,1100,103370501
20100414,89480507,7964900,5100,212231,0,89692738
20100413,92169145,17444196,5200,211445,3900,92380590
20100412,89060984,40376602,1400,10092,5000,89071076
20100409,50663640,22077191,1400,10197,0,50673837
20100408,30233781,5147142,1400,10110,0,30243891
20100407,25086826,15141395,2800,38418,1400,25125244
20100406,10091243,3329461,1400,10267,0,10101510
20100402,6762781,207516,1500,11929,0,6774710
20100401,6842114,1054024,2200,17325,0,6859439
20100331,5824813,5866316,2900,24142,3100,5848955
